Operator,Active,Idle,Plugged,New,Unknown,Total
Chevron U.S.A. Inc.,16822,8948,31432,725,10,57937
Aera Energy LLC,14538,8742,32305,821,5,56411
California Resources Production Corporation,3062,3693,4117,116,1,10989
Sentinel Peak Resources California LLC,4317,2010,4194,188,0,10709
"California Resources Elk Hills, LLC",4278,2890,2594,380,10,10152
"Berry Petroleum Company, LLC",2554,2328,2697,234,2,7815
E & B Natural Resources Management Corporation,1573,1354,636,50,0,3613
Tidelands Oil Production Co.,622,333,1666,5,0,2626
Union Oil Company of California,0,51,2353,0,0,2404
"CalNRG Operating, LLC",401,1150,660,3,0,2214
Crimson Resource Management Corp.,1101,497,568,28,0,2194
THUMS Long Beach Co.,1168,388,103,7,0,1666
Shell Western E&P Inc.,0,3,1590,0,0,1593
Exxon Mobil Corporation,0,6,1440,0,0,1446
Holmes Western Oil Corporation,600,251,514,61,0,1426
Mobil Oil Corporation,0,2,1313,0,1,1316
Macpherson Oil Company,650,148,276,8,0,1082
Bridge Energy LLC,325,189,451,0,0,965
Union Pacific Resources Co.,0,2,949,0,0,951
Cat Canyon Resources LLC,210,293,380,0,0,883
"Signal Hill Petroleum, Inc.",235,246,247,0,0,728
"Vaquero Energy, Inc.",466,112,115,22,0,715
Arco Western Energy Co.,0,6,687,0,0,693
Phillips Petroleum Company,0,2,686,0,0,688
"Carbon California Operating Company, LLC",421,123,121,2,0,667
"Bridgeland Resources, LLC",248,253,166,0,0,667
Pacific Coast Energy Company LP,279,168,150,3,0,600
"San Joaquin Facilities Management, Inc.",180,139,241,5,0,565
Atlantic Oil Company,0,0,563,0,0,563
"Shadow Wolf Energy, LLC",148,169,209,9,0,535
Southern California Gas Company,167,91,261,6,0,525
City of Whittier,0,3,518,0,0,521
Bellaire Oil Company,199,81,233,0,0,513
"West Energy Operating, LLC",129,255,105,0,0,489
"Warren E&P, Inc.",196,144,143,0,0,483
Team Operating LLC,131,341,0,0,0,472
"HVI Cat Canyon, Inc.",11,289,120,0,0,420
Oryx Energy Company,0,0,383,0,0,383
Naftex Operating Company,184,113,70,1,0,368
West Newport Oil Co.,0,0,353,0,0,353
Brea Canon Oil Co.,56,29,265,0,0,350
Arco Oil and Gas Co.,0,4,342,0,0,346
The Termo Company,91,70,179,2,0,342
"Kern River Holdings II, LLC",195,13,111,0,0,319
Atlantic Richfield Company,0,4,312,0,0,316
"Mobil Oil Exploration & Production North America, Inc.",0,0,291,0,0,291
Amerada Hess Corp.,0,0,289,0,0,289
Occidental Petroleum Corporation,0,3,283,0,0,286
"TRC Operating Company, Inc.",126,9,131,12,0,278
Freeport-McMoRan Oil & Gas LLC,3,33,232,0,0,268
"Sequoia Exploration, Inc.",142,72,44,0,0,258
"Petro-Lud, Inc.",123,107,21,2,0,253
Conoco Inc.,0,2,235,0,0,237
Capitol Oil Corporation,0,0,218,0,0,218
"Torrance Petroleum, Inc.",0,0,215,0,0,215
Matrix Oil Corporation,110,93,11,0,0,214
"Dominguez Energy, L.P.",0,0,207,0,0,207
Nahama & Weagant Energy Company,0,0,199,0,0,199
Sunset Oil Company,0,2,188,0,0,190
Pyramid Oil Company,0,2,177,0,0,179
Pacific Gas and Electric Company,104,8,66,0,0,178
"Saba Petroleum, Inc.",0,0,178,0,0,178
"CMO, Inc.",56,84,34,0,0,174
Hathaway LLC,78,81,10,2,0,171
"J.P. Oil Company, LLC",46,64,60,0,0,170
Tesoro Petroleum Corp.,0,0,169,0,0,169
Trico Industries Inc,0,1,167,0,0,168
State Lands Commission,1,76,77,9,0,163
Marathon Oil Company,0,1,162,0,0,163
"Santa Maria Energy, LLC",75,54,29,2,0,160
Drilling & Production Co.,55,10,95,0,0,160
"Oro Negro, Inc.",0,0,158,0,0,158
"Royale Energy, Inc.",14,23,112,1,0,150
"California Resources Long Beach, Inc.",55,41,53,0,0,149
Rosetta Resources Operating LP,0,0,145,0,0,145
"DCOR, LLC",80,33,29,0,0,142
"Towne Exploration Company, LP",12,3,126,0,0,141
TXO Production Corp.,0,0,138,0,0,138
ABA Energy Corporation,18,2,117,0,0,137
"Getty Reserve Oil, Co.",0,0,131,0,0,131
"Griffin Resources, LLC",0,106,22,0,0,128
"Venoco, LLC",0,16,109,0,0,125
Crown Central Petro. Corp.,0,0,123,0,0,123
UMC Petroleum Corp.,0,0,123,0,0,123
Merit Energy Company,0,0,119,0,0,119
"The Newhall Land and Farming Company, LLC",0,2,113,0,0,115
"Synergy Oil & Gas, LLC",63,20,31,0,0,114
Etchegoin Oil LLC,16,51,46,0,0,113
Tri-Valley Oil & Gas Co.,0,16,97,0,0,113
"Sierra Resources, Inc.",87,17,8,0,0,112
Armstrong Petroleum Corporation,3,7,102,0,0,112
C. C. Harris Oil Co.,0,43,68,0,0,111
Sherman Havens,0,55,55,0,0,110
"Petro Resources, Inc.",11,18,79,0,0,108
Argo Petroleum Corp.,0,11,96,0,0,107
"Sunray Petroleum, Inc.",0,64,42,0,0,106
"Kenneth H. Hunter,Jr., Trustee Of The Hunter Living Trust",0,0,106,0,0,106
Great Basins Petroleum Co.,0,0,105,0,0,105
Huntington Beach Company,0,0,104,0,0,104
Rothschild Oil Co.,0,0,104,0,0,104
Natural Gas Corp. of Calif.,0,0,101,0,0,101
"Kelt Oil and Gas, Inc.",0,0,100,0,0,100
Western Continental Operating Company,0,0,98,0,0,98
"SOC Resources, Inc.",0,1,95,0,0,96
"Richard S. Rheem, Operator",0,0,96,0,0,96
CalResources LLC,0,0,95,0,0,95
"EOG Resources, Inc.",0,0,95,0,0,95
"Transco Oil & Gas, Inc.",0,0,95,0,0,95
"Pioneer Exploration, LLC",58,28,8,0,0,94
"25 Hill Properties, Inc.",16,33,45,0,0,94
Caltico Oil Corp.,0,33,61,0,0,94
"Amerada Hess Corp., Unit Operator",0,0,94,0,0,94
"Stream Energy, Inc.",0,4,89,0,0,93
"Donald C Slawson Expl Co., Inc",0,0,93,0,0,93
Samson Resources Co.,0,0,91,0,0,91
Caballero Operations LLC,46,44,0,0,0,90
Standing Bear Petroleum Inc.,0,0,89,0,0,89
Petro-Lewis Corp.,0,0,88,0,0,88
Arkoma Production Company of California,0,0,86,0,0,86
Seaside Oil Co.,0,0,86,0,0,86
Kraemer II LLC,0,0,85,0,0,85
Triton Oil & Gas Corp.,0,0,85,0,0,85
Castle Minerals,0,0,78,0,0,78
"Hilliard Oil & Gas, Inc.",0,0,77,0,0,77
Arcady Oil Company,0,0,75,0,0,75
Venada National,0,0,75,0,0,75
Hellman Properties LLC,52,14,7,0,0,73
Anacapa Oil Corporation,0,0,73,0,0,73
"Central Lease, Inc.",0,4,68,0,0,72
State of California,0,1,71,0,0,72
Blackhawk Oil Company,0,0,71,0,0,71
Lario Oil & Gas Co.,0,0,71,0,0,71
Longview Production Co.,0,0,71,0,0,71
John A. Thomas,49,21,0,0,0,70
Rancho La Brea Oil co.,0,4,66,0,0,70
Morton and Dolley,0,0,70,0,0,70
"Longbow, LLC",43,4,22,0,0,69
Trio Petroleum LLC,5,26,35,3,0,69
"B. E. Conway Energy, Inc.",52,8,8,0,0,68
Valley Water Management Company,10,40,18,0,0,68
Medallion Calif Properties Co.,0,0,68,0,0,68
"Cooper & Brain, Inc.",49,3,15,0,0,67
"Patriot Resources, LLC",18,31,17,0,0,66
"Thompson Oil Company, Inc.",41,23,1,0,0,65
Golden Bear Oil Company,0,0,65,0,0,65
"Emjayco, L. P.",0,0,64,0,0,64
Grace Petroleum Corp.,0,0,64,0,0,64
Angus Petroleum Corporation,10,19,33,0,0,62
L.A. Terminal & Transport Co.,0,62,0,0,0,62
Neaves Petro. Developments,0,0,62,0,0,62
Hillcrest Beverly Oil Corp.,18,20,23,0,0,61
"LDD Energy, LLC",7,13,41,0,0,61
Union Consolidated Crude Oil Co.,0,47,14,0,0,61
Quintana Petroleum Corporation,0,0,60,0,0,60
"Dole Enterprises, Inc.",24,11,24,0,0,59
Petrogulf Corporation,0,2,57,0,0,59
Estate of Louise E. Dabney,0,1,58,0,0,59
Sage-California,0,0,59,0,0,59
Pace Diversified Corporation,31,16,11,0,0,58
Continental Oil Company,0,1,55,0,0,56
The Port of Long Beach,0,0,56,0,0,56
"Grayson Service, Inc.",4,8,43,0,0,55
Graner Oil Co.,0,0,55,0,0,55
Westlake Oil Co.,0,54,0,0,0,54
Ferguson & Bosworth,0,0,54,0,0,54
"Key Production Company, Inc.",0,0,54,0,0,54
The Dow Chemical Company,0,0,54,0,0,54
United Energy Inc.,0,0,54,0,0,54
Westates Petroleum Co.,0,2,51,0,0,53
"Beloil Corporation, Ltd.",0,0,53,0,0,53
"Lodi Gas Storage, L.L.C.",45,1,6,0,0,52
American Oil Co.,0,2,50,0,0,52
"E. A. Bender, Operator",0,0,52,0,0,52
Lyle A. Garner,0,0,52,0,0,52
Tri-Union Development Corporation,0,0,51,0,0,51
"Harvest Petroleum, Inc.",38,12,0,0,0,50
Sun Exploration & Production Co.,0,2,48,0,0,50
"Deuel Petroleum Company, Inc.",0,0,50,0,0,50
Norris Oil Company,0,0,50,0,0,50
Northern Michigan Exploration Company,0,0,50,0,0,50
"Petro Capital Resources, LLC",24,13,12,0,0,49
Parker Oil Col,0,41,8,0,0,49
Geo Petroleum Inc.,0,0,49,0,0,49
"Omimex Petroleum, Inc.",0,0,49,0,0,49
Sun Oil Company,0,0,49,0,0,49
Dekalb Energy Co.,0,0,48,0,0,48
Franklin Oil Company,0,0,48,0,0,48
"Maranatha Petroleum, Inc.",31,4,8,4,0,47
LBTH Inc.,13,25,9,0,0,47
"Zynergy, LLC",2,44,1,0,0,47
Laymac Corporation,0,1,46,0,0,47
Black Mountain Oil Co.,0,0,47,0,0,47
C. W. Colgrove,0,0,47,0,0,47
James S. Anderson,20,5,21,0,0,46
Adolfo Camarillo,0,0,46,0,0,46
Aspen Exploration Corporation,0,0,46,0,0,46
Coastal Oil and Gas Corporation,0,0,46,0,0,46
Central Pacific Resources,33,6,6,0,0,45
Bridgemark Corporation,8,2,35,0,0,45
Southern California Edison Co.,0,3,42,0,0,45
The Superior Oil Co.,0,1,44,0,0,45
McCulloch Oil & Gas Corp.,0,0,45,0,0,45
"Tonner Hills SSP, LLC",0,0,45,0,0,45
"NY Oil, Inc.",27,16,1,0,0,44
Standard Oil Company LLC,0,41,3,0,0,44
Argosy Oil Company,0,0,44,0,0,44
Gray Development Co. LLC,28,4,11,0,0,43
International Oil Devel Inc. Lt,0,3,40,0,0,43
Atlantic Richfield Co.,0,0,43,0,0,43
Fenian Oil Corporation,0,0,43,0,0,43
Huntington Harbour Corp.,0,0,43,0,0,43
Ballard Oil Inc.,0,32,10,0,0,42
A. J. Hayes,0,0,42,0,0,42
County of Los Angeles,0,0,42,0,0,42
"E. C. Brown, Operator",0,0,42,0,0,42
Energy Production & Sales Co.,0,0,42,0,0,42
"McFarland Energy, Inc.",0,0,42,0,0,42
Peak Operator LLC,4,37,0,0,0,41
First Oil and Gas Company,0,40,1,0,0,41
Channel Exploration Company,0,0,41,0,0,41
"Continental Development of Calif., Inc.",0,0,41,0,0,41
E. A. Bender,0,0,40,0,0,40
Home-Stake Production Co.,0,0,40,0,0,40
"Caleco, LLC",19,20,0,0,0,39
Citadel Exploration Inc.,14,25,0,0,0,39
A. S. Johnston Drilling Corp.,0,0,38,0,0,38
Brazos Oil and Gas Company,0,0,38,0,0,38
Dominguez Properties,0,0,38,0,0,38
Hathaway Company,0,0,38,0,0,38
Whiting Oil and Gas Corporation,0,0,38,0,0,38
"O'Donnell Oil, LLC",10,4,23,0,0,37
TRC Cypress Group LLC,0,5,32,0,0,37
J. E. O'Donnell,0,4,33,0,0,37
Callon Petroleum Co.,0,0,37,0,0,37
Exxon Corporation,0,0,37,0,0,37
"W. W. Holmes, Operator",0,0,37,0,0,37
Cbase Corporation,31,3,2,0,0,36
Gordon Dole,22,5,9,0,0,36
Allied Western Petroleum,0,36,0,0,0,36
Decalta International Corporation,0,0,36,0,0,36
General Exploration Co.,0,0,36,0,0,36
MACPET,0,0,36,0,0,36
Macrate Oil Co.,0,0,36,0,0,36
Hunnicutt & Camp Drilling Co.,0,0,35,0,0,35
Santa Fe Minerals,0,0,35,0,0,35
"PEOCO, LLC",12,18,4,0,0,34
260 Resource Management LLC,11,23,0,0,0,34
"INNEX California, Inc.",10,20,4,0,0,34
"PowerDrive Energy Services Company, LLC",7,27,0,0,0,34
Ancora-Verde Corporation,0,0,34,0,0,34
"Apex Petroleum Corporation, Ltd.",0,0,34,0,0,34
"City Oil Corp., Oper. for",0,0,34,0,0,34
J. Paul Getty,0,0,34,0,0,34
Porter Sesnon et al,0,0,34,0,0,34
West American Energy Corporation,23,4,6,0,0,33
Clean Energy Systems Placerita Inc.,0,6,27,0,0,33
Unknown Operator,0,5,28,0,0,33
Crest Oil & Gas Management Corp.,0,1,32,0,0,33
"Polaris Production, Inc.",0,0,33,0,0,33
"Chemassist, L.L.C.",21,10,1,0,0,32
Central California Oil Co.,12,2,18,0,0,32
KB Oil & Gas,5,25,2,0,0,32
Vern Jones Oil & Gas Corp.,1,2,29,0,0,32
H. Rogalske,0,25,7,0,0,32
Jaco Production Company,0,21,11,0,0,32
Casex Company,0,0,32,0,0,32
Coast Supply Company Ltd.,0,0,32,0,0,32
Estate of Howard F. O'Brien,0,0,32,0,0,32
"New Chaparral Petroleum, Inc.",0,0,32,0,0,32
Production Specialties Company,0,0,32,0,0,32
"Midway-Sunset Investors, LLC",22,7,2,0,0,31
California Petroleum Group Inc.,7,23,0,1,0,31
"Vesta Oil and Gas, LLC",0,28,3,0,0,31
H. A. Ivers,0,7,24,0,0,31
Ring Oil Co.,0,1,30,0,0,31
Alanmar Energy,0,0,31,0,0,31
BP Exploration U.S.A. Inc.,0,0,31,0,0,31
Pacific Energy Resources Ltd.,0,0,31,0,0,31
"D D Natural Resources, LLC",29,0,1,0,0,30
Lobo Operations LLC,20,10,0,0,0,30
"Macpherson Operating Company, L.P.",16,4,10,0,0,30
"HOC CA, LLC",10,19,1,0,0,30
CAAC 100 LLC,3,27,0,0,0,30
Watt Mineral Holdings LLC,0,30,0,0,0,30
E. A. Doran Oil Co.,0,14,16,0,0,30
California Oil Co.,0,0,30,0,0,30
G E Kadane & Sons,0,0,30,0,0,30
Harry S. Rothschild,0,0,30,0,0,30
"Reserve Oil, Inc.",0,0,30,0,0,30
Reynolds & Carver,0,0,30,0,0,30
"S. M. Reynolds, Opr.",0,0,30,0,0,30
"Northwest Petroleum, Inc.",0,5,24,0,0,29
Bradford Bishop,0,0,29,0,0,29
"Energy Development of California, Inc.",0,0,29,0,0,29
Franwin Oil And Gas Co.,0,0,29,0,0,29
G.E.C. Oil and Gas Operations,0,0,29,0,0,29
Gilmore Oil Co.,0,0,29,0,0,29
JXR Company,0,0,29,0,0,29
"Monterey Resources, Inc.",0,0,29,0,0,29
"S & C Oil Co., Inc.",14,1,13,0,0,28
"Nasco Petroleum, L.L.C.",9,19,0,0,0,28
Dalen Resources Oil & Gas Co.,0,0,28,0,0,28
Enerfin Resources Northwest Limited Partnership,0,0,28,0,0,28
Nord-Montara Petroleum Company,0,0,28,0,0,28
Pauley Petroleum Inc.,0,0,28,0,0,28
Petroleum Securities Co.,0,0,28,0,0,28
Potomac Wells,0,0,28,0,0,28
C & M Oil Co. & Investments,27,0,0,0,0,27
Wellington Oil Co.,0,27,0,0,0,27
"The Nahabedian Exploration Group, LLC",0,3,24,0,0,27
"Intercontinental Tech Group, Inc.",0,1,26,0,0,27
Bob Ferguson Independent,0,0,27,0,0,27
Tiger Oil Co.,0,0,27,0,0,27
"Daybreak Oil and Gas, Inc.",20,0,6,0,0,26
"R&R Resources, LLC",12,5,9,0,0,26
Hercules Oil Co.,0,24,2,0,0,26
Dwayne's Engineering,0,19,7,0,0,26
"Commander Oil Company, Ltd.",0,2,24,0,0,26
Victory Oil Company LLC,0,1,25,0,0,26
John M. Young,0,0,26,0,0,26
Trico Oil and Gas Company,0,0,26,0,0,26
"Howard E. Caywood, Inc.",11,2,12,0,0,25
"Bennett Petroleum, Inc.",7,12,6,0,0,25
"Freedom Oil Company, LLC",0,22,3,0,0,25
Apollo Energy Corporation,0,0,25,0,0,25
Condor Oil Company Inc.,0,0,25,0,0,25
El Dorado Exploration Co.,0,0,25,0,0,25
Neaves Petroleum Developments,0,0,25,0,0,25
Petrominerals Corp.,0,0,25,0,0,25
Supreme Oil & Gas Corporation,0,0,25,0,0,25
"Rare Petro Exploration, LLC",10,11,3,0,0,24
H.T. Olsen Oil & Gas Operations,4,12,8,0,0,24
College Oil Co.,0,24,0,0,0,24
Western Petroleum Co.,0,2,22,0,0,24
"Amerada Hess Corp., Operator",0,0,24,0,0,24
Great Western Drilling,0,0,24,0,0,24
Jordan Oil & Gas Company,0,0,24,0,0,24
"Gill Ranch Storage, LLC",20,0,3,0,0,23
Cimarron Oil LLC,18,0,5,0,0,23
Mission Oil Company,16,0,7,0,0,23
O'Brien-Sill,9,1,13,0,0,23
Beverly Hills Unified School District,0,3,18,2,0,23
Paris Valley Petroleum,0,1,22,0,0,23
"Yunker, Morton & Dolley",0,1,22,0,0,23
Black Velvet Petro. Co.,0,0,23,0,0,23
Frank Goldman,0,0,23,0,0,23
"Hamar Associates, LLC",0,0,23,0,0,23
Jacalitos Petroleum Co.,0,0,23,0,0,23
MCOR Oil and Gas Corporation,0,0,23,0,0,23
"Nevada Titan Energy, Inc.",0,0,23,0,0,23
Samedan Oil Corporation,0,0,23,0,0,23
Western Discovery USA Inc.,0,0,23,0,0,23
Wild Goose Storage LLC,22,0,0,0,0,22
National Oil Co.,0,21,1,0,0,22
Oak Ridge Oil Co.,0,1,21,0,0,22
"Bettie A. McBurney, Oper.",0,0,22,0,0,22
"Big West of California, LLC",0,0,22,0,0,22
CAPCO Resource Corporation,0,0,22,0,0,22
Davis Oil Co.,0,0,22,0,0,22
EHB Oil Company,0,0,22,0,0,22
Fountain Oil And Gas Co.,0,0,22,0,0,22
Hondo Oil & Gas Company,0,0,22,0,0,22
Patrick A. Doheny,0,0,22,0,0,22
"Santa Fe Minerals, Inc.",0,0,22,0,0,22
West Coast Oil Company,0,0,22,0,0,22
Ojai Oil Company,13,0,8,0,0,21
Newport Banning Ranch LLC,1,12,8,0,0,21
"AllenCo Energy, Inc.",0,21,0,0,0,21
C. Shirm,0,20,1,0,0,21
Davis Investment LLC,0,1,20,0,0,21
"Beach, Church & Bell",0,0,21,0,0,21
C. C. Killingsworth,0,0,21,0,0,21
E. A. Clampitt Co,0,0,21,0,0,21
Fred E. Cole,0,0,21,0,0,21
Green Oil Company,0,0,21,0,0,21
"Mark Morris, Inc",0,0,21,0,0,21
"Oakland Petroleum Operating Company, Inc.",0,0,21,0,0,21
Pacific American Oil Co,0,0,21,0,0,21
Santa Cruz Island Co.,0,0,21,0,0,21
Terepin Corp,0,0,21,0,0,21
"U. S. Natural Resources, Inc.",0,0,21,0,0,21
City of Newport Beach,11,5,4,0,0,20
"BRKNCO, LLC",7,6,7,0,0,20
"S & S Oil Company, LLC",0,20,0,0,0,20
Valid Energy Company,0,20,0,0,0,20
Kern Front-Section 35-Partners,0,19,1,0,0,20
L. A. R. R. Co.,0,19,1,0,0,20
Tetra Oil Company,0,11,9,0,0,20
Oceanic Oil Co.,0,7,13,0,0,20
Delaney Petroleum Corp.,0,3,17,0,0,20
Alpine Oil & Gas Corp.,0,0,20,0,0,20
Coast Exploration Company,0,0,20,0,0,20
"Gene Reid Drilling, Inc.",0,0,20,0,0,20
Horace Steele,0,0,20,0,0,20
"Kenneth H. Hunter, Jr.",0,0,20,0,0,20
Sargent Oil Co.,0,0,20,0,0,20
Shanley-Montara Petroleum Co.,0,0,20,0,0,20
Teal Petroleum Company,0,0,20,0,0,20
Venezia Oil Corp.,0,0,20,0,0,20
Wood-Callahan,0,0,20,0,0,20
Almond Crest Oil LLC,14,4,1,0,0,19
"Thompson Energy Resources, LLC",11,8,0,0,0,19
Redbank Oil Co.,9,5,5,0,0,19
"Concordia Resources, Inc.",8,10,1,0,0,19
Astarta Alexander Oil Co. LLC,0,17,2,0,0,19
"Western States International, Inc.",0,4,15,0,0,19
Tenneco Oil Company,0,1,18,0,0,19
Ann Marie Tiers,0,0,19,0,0,19
Carr and Wrath,0,0,19,0,0,19
"E. L. Doheny, Operator",0,0,19,0,0,19
L. M. Lockhart,0,0,19,0,0,19
N.E.C.K. Petroleum Company,0,0,19,0,0,19
Ogle Petroleum Inc.,0,0,19,0,0,19
Reserve Oil Company,0,0,19,0,0,19
"Royalty Service Corp., Ltd.",0,0,19,0,0,19
Selbar Oil Co.,0,0,19,0,0,19
Shanley-Montara Petro. Co.,0,0,19,0,0,19
South Coast Oil Corporation,0,0,19,0,0,19
The Hall-Baker Company,0,0,19,0,0,19
The Petrol Corp.,0,0,19,0,0,19
"Premier Pumping Unit Services, Inc.",10,5,3,0,0,18
California Oil Independents,0,17,1,0,0,18
Manley Oil Co.,0,17,1,0,0,18
Barnhart-Morrow Consolidated,0,1,17,0,0,18
Empire Oil Co.,0,1,17,0,0,18
Barto Oil Co.,0,0,18,0,0,18
Cal-L Expl. Corp.,0,0,18,0,0,18
Franco Western Oil Company,0,0,18,0,0,18
Hillside Oil Partners,0,0,18,0,0,18
Miller Oil Co.,0,0,18,0,0,18
Sumpf-Williams,0,0,18,0,0,18
"YLRICHARDS4ACRES2015, LLC",0,0,18,0,0,18
Zephyr Oil Co.,0,0,18,0,0,18
Bruce A. Holmes,6,3,8,0,0,17
I. W. Shirley,0,16,1,0,0,17
Alamo Oil Company,0,1,16,0,0,17
Phillips Petroleum Co.,0,1,16,0,0,17
West Side Rentals,0,1,16,0,0,17
Central Park Energy,0,0,17,0,0,17
ChevronTexaco Exploration & Production Company,0,0,17,0,0,17
"Foothill Energy, LLC",0,0,17,0,0,17
Gene Reid Exploration Company,0,0,17,0,0,17
H. T. Hilliard & Co.,0,0,17,0,0,17
Hershey Oil Corporation,0,0,17,0,0,17
Kernview Oil Co.,0,0,17,0,0,17
"Lobodo, Inc.",0,0,17,0,0,17
Morton and Sons,0,0,17,0,0,17
Nordic Oil Company,0,0,17,0,0,17
Oxy Petroleum Inc.,0,0,17,0,0,17
Pacific Supply Cooperative,0,0,17,0,0,17
Republic Petroleum Co.,0,0,17,0,0,17
Reserve Oil & Gas Co.,0,0,17,0,0,17
Russell L. Williams,0,0,17,0,0,17
Seaward Resources Inc.,0,0,17,0,0,17
Source Energy Corp.,0,0,17,0,0,17
Tom Jones,0,0,17,0,0,17
E & T Limited Liability Co.,16,0,0,0,0,16
"Plegel Oil Company, Inc.",14,2,0,0,0,16
"Optima Conservation Resources Exploration, LLC",13,2,1,0,0,16
"Renaissance Petroleum, LLC",9,0,0,7,0,16
C. Case Company,7,4,5,0,0,16
Axis Petroleum Co.,7,0,9,0,0,16
Dr. J. Von Gal-Scale,0,16,0,0,0,16
Coast Range Oil Co.,0,10,6,0,0,16
Parcan Oil Co.,0,2,14,0,0,16
"Sunset Exploration, Inc.",0,2,14,0,0,16
"H.L. Hall & Sons, LLC",0,1,15,0,0,16
Block Oil Co.,0,0,16,0,0,16
Cabeen Exploration Corp,0,0,16,0,0,16
"Center at Needham Ranch Land, LLC",0,0,16,0,0,16
Challenger Minerals Inc.,0,0,16,0,0,16
Crestmont Oil & Gas Company,0,0,16,0,0,16
CRG Properties Ltd.,0,0,16,0,0,16
E & E Prod.,0,0,16,0,0,16
Ebert & Brandt,0,0,16,0,0,16
J. F. Kosanke,0,0,16,0,0,16
Ken-Lynn Corporation,0,0,16,0,0,16
Lee Gibson Oil Company,0,0,16,0,0,16
Pacific Oil and Gas Development Corp.,0,0,16,0,0,16
Petrolex Inc.,0,0,16,0,0,16
Phillips Oil Company,0,0,16,0,0,16
R. B. Watkins,0,0,16,0,0,16
Rinde Oil Co.,0,0,16,0,0,16
"Titan Energy, Inc.",0,0,16,0,0,16
"Tri-State Petroleum, Inc.",0,0,16,0,0,16
Trio Petroleum Inc.,0,0,16,0,0,16
W. D. Newsom Consulting,0,0,16,0,0,16
Worldwide Energy Corp.,0,0,16,0,0,16
Duncan's Pumping Service,15,0,0,0,0,15
"Modus, Inc.",14,1,0,0,0,15
"Little Creek Properties, Inc.",10,0,5,0,0,15
"Summit Energy, LLC",8,5,2,0,0,15
"PRE Resources, LLC",7,4,4,0,0,15
Chambers & Mouren,4,0,11,0,0,15
Padre Oil Co.,1,10,4,0,0,15
Chas. V. Hall,0,15,0,0,0,15
Interstate Oil Corp.,0,7,8,0,0,15
Paul M. Woodward,0,6,9,0,0,15
United States Oil & Royalties Co.,0,6,9,0,0,15
Olinda Land Co.,0,5,10,0,0,15
Marport Oil Co.,0,3,12,0,0,15
Nate Bray (G. N.),0,2,13,0,0,15
Bishop Oil Company,0,1,14,0,0,15
Black Hawk Resources Corp.,0,0,15,0,0,15
Cake Corp.,0,0,15,0,0,15
Edward Nepple,0,0,15,0,0,15
Four Star Oil & Gas Company,0,0,15,0,0,15
Gilliland Oil & Land Co.,0,0,15,0,0,15
Havenstrite Oil Co.,0,0,15,0,0,15
J. C. Wilson,0,0,15,0,0,15
J. H. Maurer & Arthur C. Fisher,0,0,15,0,0,15
Lawrence Perryman,0,0,15,0,0,15
Marlyn Company,0,0,15,0,0,15
Nordon Corp. Ltd.,0,0,15,0,0,15
North Valley Oil & Gas Co.,0,0,15,0,0,15
PanCanadian Petroleum Company,0,0,15,0,0,15
Sage Oil Co.,0,0,15,0,0,15
"Central Valley Gas Storage, LLC",14,0,0,0,0,14
Coffee Petroleum,14,0,0,0,0,14
"Stone Cabin Resources, LLC",10,4,0,0,0,14
"Reabold California, LLC",7,3,4,0,0,14
"Drilling, Exploration & Operating Co., Inc.",5,0,9,0,0,14
"Amrich Energy, Inc.",2,10,2,0,0,14
"Ample Resources, Inc.",0,14,0,0,0,14
Knight & Sons,0,14,0,0,0,14
"Solimar Energy, LLC",0,13,1,0,0,14
Preuitt Production Service,0,9,5,0,0,14
E. L. Henthorn,0,8,6,0,0,14
H. W. Covert,0,5,9,0,0,14
"Sespe Lease, Inc.",0,5,9,0,0,14
Hartley Natural Resource Development,0,3,11,0,0,14
Leah C. Sewell & Barbara C. Jones,0,2,12,0,0,14
Rex Oil Co.,0,2,12,0,0,14
Calstar Petroleum Co.,0,1,13,0,0,14
R. R. Bush Oil Co.,0,1,13,0,0,14
Anadime Energy Services Inc.,0,0,14,0,0,14
Benton Oil & Gas,0,0,14,0,0,14
Brookline Oil Co.,0,0,14,0,0,14
California Southern Oil Co.,0,0,14,0,0,14
Chester F. Dolley,0,0,14,0,0,14
Chowchilla Gas Company,0,0,14,0,0,14
E. T. Willard,0,0,14,0,0,14
Estate of Kenneth Mills,0,0,14,0,0,14
Ferguson & Bosworth & Associates,0,0,14,0,0,14
"G. R. Nance Co., Inc.",0,0,14,0,0,14
"George J. Peckham, Jr.",0,0,14,0,0,14
Graham-Loftus Oil Corp.,0,0,14,0,0,14
Harold C. Morton,0,0,14,0,0,14
Harold C. Ramser,0,0,14,0,0,14
"J. I. Hathaway, Opr.",0,0,14,0,0,14
James H. Elison,0,0,14,0,0,14
Julian Petroleum Corp.,0,0,14,0,0,14
Los Nietos Co.,0,0,14,0,0,14
"Nana Oil & Gas, Inc.",0,0,14,0,0,14
P. H. & B. Oil Co.,0,0,14,0,0,14
Pinal Dome Corporation,0,0,14,0,0,14
Prado Petroleum Co.,0,0,14,0,0,14
Scott Oil Co.,0,0,14,0,0,14
"Vintage Petroleum, Inc.",0,0,14,0,0,14
Wilrich Development Co.,0,0,14,0,0,14
Fourstar Resources LLC,12,1,0,0,0,13
"Kelpetro Operating, Inc.",3,5,5,0,0,13
Cree Oil LLC,1,0,12,0,0,13
Sierra Oil Co.,0,8,5,0,0,13
Crown Oil Company,0,5,8,0,0,13
MH Marr,0,4,9,0,0,13
Hub Oil Co.,0,2,11,0,0,13
E. A. Parkford,0,1,12,0,0,13
C. D. Draucker,0,0,13,0,0,13
C. F. Braun & Co.,0,0,13,0,0,13
C.M.T. Producing Co.,0,0,13,0,0,13
Cenex Inc.,0,0,13,0,0,13
Custom Drilling Co.,0,0,13,0,0,13
D D Dunlap Oil Co.,0,0,13,0,0,13
Damson Oil Corporation,0,0,13,0,0,13
Ferguson Energy,0,0,13,0,0,13
G-W Resources Oper. Co.,0,0,13,0,0,13
G.E.N.Y. Operations,0,0,13,0,0,13
Grover Collins,0,0,13,0,0,13
"H. O. Strickler, Operator",0,0,13,0,0,13
Hamilton Brothers Oil Company,0,0,13,0,0,13
Hrubetz Oil Co.,0,0,13,0,0,13
Huntington Signal Oil Company,0,0,13,0,0,13
Kenneth Sperry,0,0,13,0,0,13
Lawrence P. Reischman,0,0,13,0,0,13
Leroy C. Gould,0,0,13,0,0,13
Mariposa Petroleum Co.,0,0,13,0,0,13
Marlin Pacific Oil & Gas,0,0,13,0,0,13
Miley Petro. Corp.Ltd,0,0,13,0,0,13
Montara Petroleum Company,0,0,13,0,0,13
Nevada Phoenix Ener. Corp.,0,0,13,0,0,13
"Noble Energy, Inc.",0,0,13,0,0,13
North Star Mining & Dev. Co.,0,0,13,0,0,13
Ratterree Land Co.,0,0,13,0,0,13
"Sam B. Herndon, Operator",0,0,13,0,0,13
Shell Oil Company,0,0,13,0,0,13
Sinco Oil Corp.,0,0,13,0,0,13
T & T Oil Co.,0,0,13,0,0,13
Tannehill Oil Company,0,0,13,0,0,13
Tatum Petroleum Corporation,0,0,13,0,0,13
The Hampton Oil Corporation,0,0,13,0,0,13
Thomas Oil Company,0,0,13,0,0,13
Torch Operating Company,0,0,13,0,0,13
Transamerica Development Company,0,0,13,0,0,13
Triple A Industries Inc.,0,0,13,0,0,13
U S Natural Resources,0,0,13,0,0,13
Vista Grande Oil Co.,0,0,13,0,0,13
"Belridge Energy Resources, Inc.",12,0,0,0,0,12
"P&M Oil Company, Inc.",11,1,0,0,0,12
Silverbacq LLC,9,0,3,0,0,12
Yoelin Family Trust,8,2,2,0,0,12
Havens Oil Company,4,8,0,0,0,12
"McLennan Family Properties, LLP",4,0,8,0,0,12
Park Crude Oil Co.,0,12,0,0,0,12
Phelps & Beveridge,0,12,0,0,0,12
Ruhland Oil Co.,0,12,0,0,0,12
"The Eric and Susan Dunn Living Trust dated July 27, 2006",0,12,0,0,0,12
Uncle Sam Oil Co.,0,12,0,0,0,12
Arthur McAdams,0,11,1,0,0,12
"Sacramento Energy, Inc.",0,8,4,0,0,12
Mercury Oil Co.,0,7,5,0,0,12
Brittany Oil Co.,0,5,7,0,0,12
Hogan Petroleum Company,0,3,9,0,0,12
Allied Petroleum Corp,0,1,11,0,0,12
A. J. Delaney,0,0,12,0,0,12
Aeco Corporation,0,0,12,0,0,12
Allscope Resources International Inc.,0,0,12,0,0,12
American Pacific International,0,0,12,0,0,12
Apache Corporation,0,0,12,0,0,12
Artnell Oil & Gas Co.,0,0,12,0,0,12
Barron Kidd,0,0,12,0,0,12
Beacon Oil Company,0,0,12,0,0,12
"California Lands, Inc.",0,0,12,0,0,12
California Time Petroleum Inc.,0,0,12,0,0,12
Century Oil Co.,0,0,12,0,0,12
Cities Service Oil Co.,0,0,12,0,0,12
Edwin W. Pauley,0,0,12,0,0,12
Estate of Chas. W. Camp,0,0,12,0,0,12
Estate of Welburn Mayock,0,0,12,0,0,12
Geochemical Surveys,0,0,12,0,0,12
Hamilton and Sherman,0,0,12,0,0,12
J. K. Wadley,0,0,12,0,0,12
King Petrol Co.,0,0,12,0,0,12
MCBO OIL CO.,0,0,12,0,0,12
Oakwood Petroleum Corp.,0,0,12,0,0,12
"Olson & Gregg, Inc.",0,0,12,0,0,12
Pan American Energy Corporation,0,0,12,0,0,12
Pan Western Petroleum Co.,0,0,12,0,0,12
Pedro Petroleum Corporation,0,0,12,0,0,12
"Petersen Production Company, LLC",0,0,12,0,0,12
S. H. Montgomery,0,0,12,0,0,12
San Roque Oil & Exploration Co.,0,0,12,0,0,12
Seaboard Oil & Gas Co.,0,0,12,0,0,12
Stockdale Energy Co.,0,0,12,0,0,12
SWC Resources Inc,0,0,12,0,0,12
"T. A. Atkinson, Opr.",0,0,12,0,0,12
Tejon Industrial Corp.,0,0,12,0,0,12
U. S. Forest Service,0,0,12,0,0,12
"Viscosity Control Systems, Inc.",0,0,12,0,0,12
"Woolner Oil Corp., Ltd.",0,0,12,0,0,12
Yunker Oil Co.,0,0,12,0,0,12
"Power Run Oil, LLC",9,0,2,0,0,11
T. E. Adams Petroleum Corp.,7,4,0,0,0,11
Verjill Oil Company,5,6,0,0,0,11
Engineers Oil Company,4,0,7,0,0,11
City of Huntington Beach (Fire Dept.),3,0,8,0,0,11
"J & K Operating Company, Inc.",3,0,8,0,0,11
Edison Beneficial Reuse,2,9,0,0,0,11
Consolidated Crude Corp.,0,11,0,0,0,11
Wilson & Wheat,0,11,0,0,0,11
Joro Inc.,0,10,1,0,0,11
"South Fork Ranch, LLC",0,10,1,0,0,11
Mitchell Oil,0,8,3,0,0,11
"Chaparral Petroleum, Inc.",0,4,7,0,0,11
Garbutt Oil Co. (A. M. Stephens Co.),0,4,7,0,0,11
Rio Virgin Oil Syndicate,0,3,8,0,0,11
Allied Energy Corp.,0,2,9,0,0,11
Elmer C. Von Glahn,0,1,10,0,0,11
"George F. Getty, Inc.",0,1,10,0,0,11
Scope Industries,0,1,10,0,0,11
Thornbury Drilling Co.,0,1,10,0,0,11
A. J. West Operator,0,0,11,0,0,11
A. Lansdale,0,0,11,0,0,11
"A.L.S. Resources, Inc.",0,0,11,0,0,11
American Petrofina Expl. Co.,0,0,11,0,0,11
B. C. Mackey,0,0,11,0,0,11
Berry Holding Co.,0,0,11,0,0,11
British-American Oil Producing Co.,0,0,11,0,0,11
Cockriel Petroleum,0,0,11,0,0,11
D. B. M. Oil Company,0,0,11,0,0,11
"D. J. Pickrell, Operator",0,0,11,0,0,11
Fred Ash & Sons,0,0,11,0,0,11
G. A. Grober,0,0,11,0,0,11
Goodman Santa Fe Springs SPE LLC,0,0,11,0,0,11
"Graham Royalty, Ltd.",0,0,11,0,0,11
Industrial Development Associates,0,0,11,0,0,11
Java Oil,0,0,11,0,0,11
King Resources Company,0,0,11,0,0,11
Legacy Energy Inc.,0,0,11,0,0,11
"M. Barratt and Ernest W. Bysshe, Jr.",0,0,11,0,0,11
Moriqui Exploration Co.,0,0,11,0,0,11
"Navy Oil Co., Inc.",0,0,11,0,0,11
Ne-Tex Oil Corp.,0,0,11,0,0,11
North American Oil Consolidated,0,0,11,0,0,11
Paul F. McKenzie,0,0,11,0,0,11
"Paul F. McKenzie, Opr.",0,0,11,0,0,11
R. W. Henry,0,0,11,0,0,11
Razar Resources,0,0,11,0,0,11
S. A. Camp Companies,0,0,11,0,0,11
Schell & Jennings,0,0,11,0,0,11
T L Jamieson,0,0,11,0,0,11
"The Hall-Baker Company, Ltd.",0,0,11,0,0,11
The National Oil Company,0,0,11,0,0,11
The Sharples Oil Corp.,0,0,11,0,0,11
"Tonka Energy, Inc.",0,0,11,0,0,11
U. S. Drilling Co.,0,0,11,0,0,11
Valwood Production Company,0,0,11,0,0,11
Venturini Associates Inc.,0,0,11,0,0,11
W. R. Holcomb,0,0,11,0,0,11
Western Minerals Co.,0,0,11,0,0,11
"Wilshire Oil Company, Inc.",0,0,11,0,0,11
"Arrowhead Operating, Inc.",10,0,0,0,0,10
Elliott Underground LLC,10,0,0,0,0,10
Pentarch Petroleum,9,0,1,0,0,10
"Res-Tech, Inc.",2,8,0,0,0,10
Equity Petro. Co.,0,10,0,0,0,10
"PS126 Investments, LLC",0,10,0,0,0,10
British Calif. Oil Co.,0,9,1,0,0,10
Costa Loma Ltd.,0,7,3,0,0,10
G. H. Preuitt,0,6,4,0,0,10
Temblor Petroleum Co. LLC,0,6,3,0,1,10
East Santa Fe Oil Co.,0,1,9,0,0,10
J.A. Smith,0,1,9,0,0,10
Moreland Investment Co.,0,1,9,0,0,10
Alfred M. Hammerslough,0,0,10,0,0,10
Amax Petro. Corp.,0,0,10,0,0,10
Amoco Production Company,0,0,10,0,0,10
B & S Oil Company,0,0,10,0,0,10
Bell-Western Oil Co.,0,0,10,0,0,10
Bender Oil Operations,0,0,10,0,0,10
"C. A. Harding, Trustee",0,0,10,0,0,10
Cimarex Energy Co.,0,0,10,0,0,10
Cliff E. Zillgitt,0,0,10,0,0,10
Concho Petroleum,0,0,10,0,0,10
D. D. Feldman Oil & Gas,0,0,10,0,0,10
"D. E. Craggs, Inc.",0,0,10,0,0,10
E. C. S. Oil Co.,0,0,10,0,0,10
Estate of Howard H. Bell Jr.,0,0,10,0,0,10
Estate of W. M. Killingsworth,0,0,10,0,0,10
Eureka Oil Co.,0,0,10,0,0,10
Exeter Oil Co.,0,0,10,0,0,10
F. E. Fairfield,0,0,10,0,0,10
Floyd R. Ten Eyck,0,0,10,0,0,10
Herrera Oil & Minerals International,0,0,10,0,0,10
Hinkle Exploration Ltd.,0,0,10,0,0,10
Imperial Gypsum & Oil Corp.,0,0,10,0,0,10
Jacat Oil Co.,0,0,10,0,0,10
L. C. Dougan,0,0,10,0,0,10
Las Palmas Petroleum Corp.,0,0,10,0,0,10
Lespring Oil Co.,0,0,10,0,0,10
Lincoln Petroleum Co.,0,0,10,0,0,10
"Lloyd A. Harnish, Oper.",0,0,10,0,0,10
Lloyd S. Gilmour,0,0,10,0,0,10
Los Angeles Unified School District,0,0,10,0,0,10
McVicar-Rood,0,0,10,0,0,10
Mission Resources,0,0,10,0,0,10
Murray-Teague Assoc.,0,0,10,0,0,10
"Oil Production Management, Inc",0,0,10,0,0,10
Pennant Operating Company,0,0,10,0,0,10
Pennant Petroleum Corporation,0,0,10,0,0,10
Petaluma Oil & Gas,0,0,10,0,0,10
Prudential Minerals Exploration Corp.,0,0,10,0,0,10
Rinker Dev. Corp.,0,0,10,0,0,10
Scope Industries Inc.,0,0,10,0,0,10
Sunset Pacific Oil Co.,0,0,10,0,0,10
Target Drilling,0,0,10,0,0,10
Texinia Oil & Gas Inc.,0,0,10,0,0,10
The Geotest Co.,0,0,10,0,0,10
Trans-Oceanic Oil Corp.,0,0,10,0,0,10
Vista Petroleum Co.,0,0,10,0,0,10
"Von Glahn Oil Co., Inc.",0,0,10,0,0,10
W. W. Holmes,0,0,10,0,0,10
"Weir Oil Co., Inc.",0,0,10,0,0,10
WH Castaic 497 LLC,0,0,10,0,0,10
Wilber J. Cox,0,0,10,0,0,10
"L P Oil Company, Inc.",9,0,0,0,0,9
Brindle/Thomas,7,1,1,0,0,9
R. J. Bellevue,6,3,0,0,0,9
"TS Leasing Operations, Inc.",6,3,0,0,0,9
Columbine Associates,4,1,4,0,0,9
ASHURST OIL LLC,0,9,0,0,0,9
Maltman Oil Co.,0,9,0,0,0,9
Midland Oil Co.,0,9,0,0,0,9
Mrs. Cake,0,9,0,0,0,9
"SMG Oil, LLC",0,9,0,0,0,9
W. R. Dudley,0,8,1,0,0,9
Dividend Oil Co.,0,4,5,0,0,9
Sentinel Oil Co.,0,3,6,0,0,9
Fortune Petroleum Corporation,0,2,7,0,0,9
Painted Hills Oil Ass'n,0,2,7,0,0,9
"Robert S. Lytle, Operator",0,2,7,0,0,9
Cube Oil Co.,0,1,8,0,0,9
Gem Oil Company,0,1,8,0,0,9
Macmillan Petroleum Corp.,0,1,8,0,0,9
Westoil Corp.,0,1,8,0,0,9
Alfred D. Mitchell,0,0,9,0,0,9
Anschutz Expl. Corp.,0,0,9,0,0,9
Barnes & Shadrick Core Drilling Co.,0,0,9,0,0,9
Barnes Core Drilling Co.,0,0,9,0,0,9
Bell Petro. Co.,0,0,9,0,0,9
C. H. Olsson,0,0,9,0,0,9
"Charles T. Rippy, Jr.",0,0,9,0,0,9
Chas. T. Rippy and Earl Robinett,0,0,9,0,0,9
"Chiksan Oil Co., Ltd.",0,0,9,0,0,9
Christopher Oil Co.,0,0,9,0,0,9
Conversion Bakersfield II Inc.,0,0,9,0,0,9
D. C. R. Bailey,0,0,9,0,0,9
Deuel Pet. Co. Inc.,0,0,9,0,0,9
E. G. Curtis,0,0,9,0,0,9
E. S. Brooks,0,0,9,0,0,9
Edward M Tilbury,0,0,9,0,0,9
Enterprise Oil Company,0,0,9,0,0,9
Entex Oil Company,0,0,9,0,0,9
Falcon Petroleum Company,0,0,9,0,0,9
Federal Oil Co. of Cal,0,0,9,0,0,9
Gary Drilling Company,0,0,9,0,0,9
Great Yellowstone Corp.,0,0,9,0,0,9
Henry L. Lubking,0,0,9,0,0,9
Holly Development Company,0,0,9,0,0,9
J. M. Peters Co. Inc.,0,0,9,0,0,9
Juniper Petroleum Corp.,0,0,9,0,0,9
Kaye R. McCown,0,0,9,0,0,9
"Kelt Pacific, Inc.",0,0,9,0,0,9
Ketell Oil Company,0,0,9,0,0,9
L. W. Babcock,0,0,9,0,0,9
"Lion Boylston, LLC-a Delaware LLC",0,0,9,0,0,9
Lowry R Lytle,0,0,9,0,0,9
M & S Properties,0,0,9,0,0,9
Macson Oil Company,0,0,9,0,0,9
Max Pray,0,0,9,0,0,9
Maxus Exploration Company,0,0,9,0,0,9
Midhurst Oil Corp.,0,0,9,0,0,9
Milham Exploration Co.,0,0,9,0,0,9
Miller and York,0,0,9,0,0,9
Monterey Resources Inc.,0,0,9,0,0,9
Oscar S. Norton,0,0,9,0,0,9
"Output Exploration, LLC",0,0,9,0,0,9
Petan Co.,0,0,9,0,0,9
R. K. Cross Opr,0,0,9,0,0,9
Royal Res. Corp.,0,0,9,0,0,9
Sanchez-O'brien Oil & Gas Corp,0,0,9,0,0,9
Santa Fe Petro Co.,0,0,9,0,0,9
Saratoga Company,0,0,9,0,0,9
Shoshone Oil Corp.,0,0,9,0,0,9
"Signal Petroleum Company of California, Ltd.",0,0,9,0,0,9
Southern California Drilling Co.,0,0,9,0,0,9
Southwest Diversified/Coscan Partners,0,0,9,0,0,9
State Energy & Development Company,0,0,9,0,0,9
Sunrise Petroleum Co.,0,0,9,0,0,9
Terminal Drilling Company,0,0,9,0,0,9
The British American Oil Producing Company,0,0,9,0,0,9
The Harter Family Trust of 1995,0,0,9,0,0,9
Tosco Enhanced Oil Recovery Corporation,0,0,9,0,0,9
Two Bay Petroleum,0,0,9,0,0,9
Valley Drudis Corp.,0,0,9,0,0,9
West American Oil Co.,0,0,9,0,0,9
"Harter Energy, Inc.",7,1,0,0,0,8
Smilodon Oil Company,7,1,0,0,0,8
The Lansdale Co.,7,0,1,0,0,8
Premier Resource Management,4,4,0,0,0,8
"Vaughn, LLC",2,0,6,0,0,8
"Doran, Brouse & Price",0,8,0,0,0,8
Lehigh Oil Co.,0,8,0,0,0,8
Parker Morrell Oil Co.,0,8,0,0,0,8
"Windrush Operating Co, LLC",0,8,0,0,0,8
Otto Ritzert,0,5,3,0,0,8
Consolidated Mutual Oil Co.,0,4,4,0,0,8
"RoseMain 031, LLC",0,4,4,0,0,8
"Archer Operations, California, LLC",0,1,7,0,0,8
Imperial Oil Co.,0,1,7,0,0,8
Manley Energy Resources LLC,0,1,7,0,0,8
"A. A. Hopkins, Jr., Operator",0,0,8,0,0,8
American Hunter Expl. Ltd.,0,0,8,0,0,8
BP Exploration Inc.,0,0,8,0,0,8
Buffalo Oil Co.,0,0,8,0,0,8
Bunker Oil Corp.,0,0,8,0,0,8
C. C. Killingsworth Opr.,0,0,8,0,0,8
"Carneros Energy, Inc.",0,0,8,0,0,8
Chanslor-Western Oil & Development Company,0,0,8,0,0,8
Charles C. Townsend,0,0,8,0,0,8
D. J. Hatfield,0,0,8,0,0,8
D. Monroe,0,0,8,0,0,8
Empire State Oil Co.,0,0,8,0,0,8
"Estate of Edward A. Nepple, W. A. MacMullen, Trustee",0,0,8,0,0,8
"F. J. Stefanich, Operator",0,0,8,0,0,8
"GEC Oil & Gas Co, Inc.",0,0,8,0,0,8
Gene Reid Drilling Company,0,0,8,0,0,8
George Hocking,0,0,8,0,0,8
Grover Collins Drilling Mud Eng. & Mat.,0,0,8,0,0,8
H & T Oil Co.,0,0,8,0,0,8
Hexadyne Energy Corp.,0,0,8,0,0,8
Hickerson Oil Company,0,0,8,0,0,8
Horizon Operating Co.,0,0,8,0,0,8
Husky Oil Co.,0,0,8,0,0,8
J. C. Hansmeyer Oil Co.,0,0,8,0,0,8
"J. M. Van Horn, Operator",0,0,8,0,0,8
John L. Sowers,0,0,8,0,0,8
John S. Hagestad,0,0,8,0,0,8
Kenneth A. Ross Jr.,0,0,8,0,0,8
"King Petroleum Development, Inc.",0,0,8,0,0,8
Lyle A. Garner & Roy Price,0,0,8,0,0,8
M J M & M Oil Co.,0,0,8,0,0,8
Maxoil Inc.,0,0,8,0,0,8
"Megatoys Property, LLC",0,0,8,0,0,8
North Star Wharf,0,0,8,0,0,8
Nuevo Energy Company,0,0,8,0,0,8
Olympic Refining Co.,0,0,8,0,0,8
Pacific Drilling Co,0,0,8,0,0,8
"Peter Cook, Jr.",0,0,8,0,0,8
Petroleum Midway Co.,0,0,8,0,0,8
Phoenix West Oil and Gas Corporation,0,0,8,0,0,8
"Porter Sesnon, Operator",0,0,8,0,0,8
"R. B. Montgomery, Oper.",0,0,8,0,0,8
Rupe Resources,0,0,8,0,0,8
S. I. Corp.,0,0,8,0,0,8
Sacramento Natural Gas Co.,0,0,8,0,0,8
"Terra Exploration & Production Co., Inc.",0,0,8,0,0,8
Topko N. Wilmington Prtnrship.,0,0,8,0,0,8
U. S. Government,0,0,8,0,0,8
W. E. David,0,0,8,0,0,8
W. E. McCaslin,0,0,8,0,0,8
Wa-Me-Co Drilling Co.,0,0,8,0,0,8
Welport Oil Company,0,0,8,0,0,8
Cather-Herley Oil Company,7,0,0,0,0,7
"Pacific Palms Petroleum, LLC",7,0,0,0,0,7
Four Teams Oil Production & Exploration Inc.,6,0,1,0,0,7
Silver Exploration Company,5,2,0,0,0,7
Vast Star Corporation,5,2,0,0,0,7
"Bud's Oil Company, Inc.",5,0,2,0,0,7
Kern County Waste Management Department,4,0,3,0,0,7
Case's Used Equipment,2,4,1,0,0,7
"Mountain View Resources, LLC",2,4,1,0,0,7
"Bakersfield Renewable Fuels, LLC",0,7,0,0,0,7
Dunham & Farnsworth,0,7,0,0,0,7
Whittier Consolidated Co.,0,7,0,0,0,7
Burlington Oil Co.,0,6,1,0,0,7
Ricano Oil Co.,0,5,2,0,0,7
Alpha Oil Co.,0,4,3,0,0,7
Wilson Oil Co.,0,4,3,0,0,7
Hardison & Stewart Oil Co.,0,3,4,0,0,7
"Big Horn Oil And Gas, Inc.",0,2,5,0,0,7
H.L. Whiston,0,2,5,0,0,7
Aragon (Toluca/Colton) Properties Corp.,0,1,6,0,0,7
Burns Oil Co.,0,1,6,0,0,7
Calvin C. Green,0,1,6,0,0,7
Canoga Oil Co.,0,1,6,0,0,7
Dynasonics Corporation,0,1,6,0,0,7
"E. F. Stella, Trustee",0,1,6,0,0,7
Fred B. Foster & Co.,0,1,6,0,0,7
"Lennar Homes of California, Inc.",0,1,6,0,0,7
"Princeton Natural Gas, LLC",0,1,6,0,0,7
St. Louis Oil Co.,0,1,6,0,0,7
A. J. McGreevy Operator,0,0,7,0,0,7
A. S. Mayes,0,0,7,0,0,7
"A. S. Mayes & Associates, Ltd.",0,0,7,0,0,7
Anza Pacific Corp.,0,0,7,0,0,7
"Arthur J. Arding, Jr.",0,0,7,0,0,7
Artnell Company,0,0,7,0,0,7
Bajii Enterprises,0,0,7,0,0,7
Baker Oil And Gas Company,0,0,7,0,0,7
"Berkley Petroleum, Inc.",0,0,7,0,0,7
"Blacksand Energy, Inc.",0,0,7,0,0,7
"Botto And Miller, Trustees",0,0,7,0,0,7
Brogdon--A&K Leases,0,0,7,0,0,7
C. & S. Investment Co.,0,0,7,0,0,7
Canon Drilling Company,0,0,7,0,0,7
Carneros Oil Company,0,0,7,0,0,7
"Cen Cal Drilling, Inc.",0,0,7,0,0,7
"Cities Service Petroleum Corporation, Ltd.",0,0,7,0,0,7
City of Santa Fe Springs,0,0,7,0,0,7
Clark C. Peterson,0,0,7,0,0,7
Cliff Petroleum Company,0,0,7,0,0,7
Concord Oil Co.,0,0,7,0,0,7
Conley & Associates Inc.,0,0,7,0,0,7
"Cox Technologies, Inc.",0,0,7,0,0,7
D. D. Dunlap,0,0,7,0,0,7
"DCO Pacific City, LLC",0,0,7,0,0,7
"DEPCO, Inc.",0,0,7,0,0,7
Deuel Petroleum Calif. Inc.,0,0,7,0,0,7
E & S Production Corp.,0,0,7,0,0,7
Estate of D. W. Elliott,0,0,7,0,0,7
Fairview Expl. Co.,0,0,7,0,0,7
First National Finance Corporation,0,0,7,0,0,7
Fleet Oil Co.,0,0,7,0,0,7
Fruitvale Properties,0,0,7,0,0,7
"Geo Investment, Inc.",0,0,7,0,0,7
Hallador Production Co.,0,0,7,0,0,7
"Harry C. Long, Oper., Inc.",0,0,7,0,0,7
Harry Feder,0,0,7,0,0,7
Home Petroleum Corp.,0,0,7,0,0,7
"Island Energy Partners, LLC",0,0,7,0,0,7
J. Farbstein,0,0,7,0,0,7
"J. R. Gillbergh, Operator",0,0,7,0,0,7
Kenneth & Katherine Manley,0,0,7,0,0,7
"Kenyon C. Sills, Operator, Inc.",0,0,7,0,0,7
Kern Co. Drilling Co. and Associates,0,0,7,0,0,7
L. T. Mayo,0,0,7,0,0,7
Leda Petroleum Co.,0,0,7,0,0,7
"Lee Lamberson, Inc.",0,0,7,0,0,7
"Lloyd Corporation, Ltd.",0,0,7,0,0,7
Lloyd Management Corporation,0,0,7,0,0,7
Lomax Exploration Co.,0,0,7,0,0,7
M. G. Anlauf,0,0,7,0,0,7
M. Manley,0,0,7,0,0,7
Magness Petroleum Company,0,0,7,0,0,7
Marmac Resources Co.,0,0,7,0,0,7
"Monument Production, Inc.",0,0,7,0,0,7
North of River Sanitary District,0,0,7,0,0,7
Northern Energy Devel. Co.,0,0,7,0,0,7
O. C. Field Gasoline Corp.,0,0,7,0,0,7
Oilco Petroleum Development,0,0,7,0,0,7
Pacific Enterprises Oil Co. (USA),0,0,7,0,0,7
Pacific Inland Operating Corporation,0,0,7,0,0,7
Palomar Oil and Refining Corporation,0,0,7,0,0,7
"PCH FFWA, LLC",0,0,7,0,0,7
Peninsula Open Space Trust,0,0,7,0,0,7
Peter B. Rothschild,0,0,7,0,0,7
Providential Development Co.,0,0,7,0,0,7
"Pueblo Oil & Gas, Inc.",0,0,7,0,0,7
"R. F. Oakes, E. E. Combs, et al",0,0,7,0,0,7
Ridge Hill Oil Co.,0,0,7,0,0,7
Riley Barnes,0,0,7,0,0,7
Royal American Petro. Corp.,0,0,7,0,0,7
Santa Maria Oil Fields Inc.,0,0,7,0,0,7
Sigmund Matejko,0,0,7,0,0,7
Steele Petroleum Company,0,0,7,0,0,7
Stowe Killingsworth,0,0,7,0,0,7
Submarine Oil Co.,0,0,7,0,0,7
Terminal Oil Co.,0,0,7,0,0,7
The Summerland Oil Co.,0,0,7,0,0,7
The Sun Drilling Co.,0,0,7,0,0,7
Thriftway Company,0,0,7,0,0,7
"Trident Oil & Gas Corporation, Inc.",0,0,7,0,0,7
"Trinity Oil Corp., Ltd.",0,0,7,0,0,7
United Oil Well Supply Co.,0,0,7,0,0,7
Vel Marv Petroleum Corp.,0,0,7,0,0,7
"Vern Jones, Oper.",0,0,7,0,0,7
Vista Pacific Resources Corporation,0,0,7,0,0,7
W. E. Nicolai & Son,0,0,7,0,0,7
"W. M. Elliott, Jr.",0,0,7,0,0,7
Wayne H. Cox,0,0,7,0,0,7
Western States Drilling Co.,0,0,7,0,0,7
William M. Keck Jr.,0,0,7,0,0,7
Woodward & Reynolds,0,0,7,0,0,7
X-L Oil Co. Inc.,0,0,7,0,0,7
Yellowstone Oil Co.,0,0,7,0,0,7
Zonal Holding Corp.,0,0,7,0,0,7
Black Badger Energy LLC.,6,0,0,0,0,6
KMP Operating Inc.,5,1,0,0,0,6
"General Production Oil, LLC",4,0,2,0,0,6
Thomas Oilers,3,1,2,0,0,6
"John Guzman Crane Service, Inc.",3,0,3,0,0,6
"NMT Oil Company, Inc.",1,3,2,0,0,6
"La Paloma Generating Company, LLC",1,0,5,0,0,6
Chas. Elton,0,6,0,0,0,6
City of Santa Clarita,0,6,0,0,0,6
E. Huntley,0,6,0,0,0,6
Lincoln Oil Co.,0,6,0,0,0,6
Little Napoleon Oil Co.,0,6,0,0,0,6
Logsdon & Sloan Syndicate No 1,0,6,0,0,0,6
Tyler Oil Co.,0,6,0,0,0,6
"Vaca Energy, LLC",0,6,0,0,0,6
Young & Shaw,0,6,0,0,0,6
Alliance Oil Co.,0,5,1,0,0,6
B & B Oil Co.,0,5,1,0,0,6
"Golden Gate Oil Operations, LLC",0,5,1,0,0,6
M. & M. Oil Co.,0,5,1,0,0,6
Lancaster Midway Oil Co.,0,4,2,0,0,6
Camerillo Refining Co.,0,3,3,0,0,6
Griffiths Oil Co.,0,3,3,0,0,6
Sespe Explorations,0,3,3,0,0,6
Charles C Townsend,0,2,4,0,0,6
Empire Oil & Gas Corp.,0,2,4,0,0,6
Pugh-Miller Drilling Co.,0,2,4,0,0,6
TB Properties,0,2,4,0,0,6
"959 Stadium Way, LLC",0,1,5,0,0,6
A.L. Kitselman,0,1,5,0,0,6
C. C. Julian,0,1,5,0,0,6
"Ed Green, Operator",0,1,5,0,0,6
"Jergins Syndicate, Inc.",0,1,5,0,0,6
L. B. Tannehill,0,1,5,0,0,6
Pacific Oil & Gas Co.,0,1,5,0,0,6
Rio Grande Oil Co.,0,1,5,0,0,6
"1552 Rockwood Street Charter Facilities, LLC",0,0,6,0,0,6
A. Wardman,0,0,6,0,0,6
Ajax Oil and Development Co.,0,0,6,0,0,6
Allts Oil Co.,0,0,6,0,0,6
Andrew Lucas & Gus Ninkovich,0,0,6,0,0,6
Arthur P. Anderson and Nancy Lee Anderson,0,0,6,0,0,6
Atlas Oil Company,0,0,6,0,0,6
"Atlas Production, Inc.",0,0,6,0,0,6
Bell Petroleum Co.,0,0,6,0,0,6
Ben F. Mingoia,0,0,6,0,0,6
Ben J. Taylor,0,0,6,0,0,6
Birch Ranch & Oil Co.,0,0,6,0,0,6
Bobbie G. & Vallee J. Williams,0,0,6,0,0,6
C & S Oil Company,0,0,6,0,0,6
"C. D. Draucker, Operator",0,0,6,0,0,6
C. D. Howe,0,0,6,0,0,6
Cadillac Oil Co.,0,0,6,0,0,6
California Natural Gas & Dev. Co.,0,0,6,0,0,6
Cameron Oil Co.,0,0,6,0,0,6
Century Oil Mgmt. Inc.,0,0,6,0,0,6
Champlin Petroleum Co.,0,0,6,0,0,6
Chanac Associates,0,0,6,0,0,6
Christiana Oil Corp.,0,0,6,0,0,6
City of Long Beach Dept. of Gas & Oil,0,0,6,0,0,6
Cozi Oil Co.,0,0,6,0,0,6
D and D Oil Company,0,0,6,0,0,6
D. D. Dunlap & Dorothy Dunlap,0,0,6,0,0,6
Deeble Investment Co.,0,0,6,0,0,6
DiGiorgio Fruit Corporation,0,0,6,0,0,6
Division of Highways,0,0,6,0,0,6
Donald J. Bentley,0,0,6,0,0,6
Driltrol,0,0,6,0,0,6
E. C. McGarry,0,0,6,0,0,6
Exeter Oil Co. Ltd.,0,0,6,0,0,6
G M V Oil Co.,0,0,6,0,0,6
"Garner & Jones, Inc.",0,0,6,0,0,6
H. A. Smith,0,0,6,0,0,6
"H. W.  Reynolds, Jr.",0,0,6,0,0,6
H. Wayne Hoylman,0,0,6,0,0,6
Harcor Energy Inc.,0,0,6,0,0,6
Harold C. Morton and H. S. Kohlbush,0,0,6,0,0,6
"Hollywood Park Land Company, LLC",0,0,6,0,0,6
"Hunt Oil USA, Inc.",0,0,6,0,0,6
Independent Exploration Company,0,0,6,0,0,6
J. B. Nelson,0,0,6,0,0,6
"James Ebert Co., Inc.",0,0,6,0,0,6
Jameson Petroleum Co.,0,0,6,0,0,6
Jas. E. Babcock,0,0,6,0,0,6
Jerry Brady,0,0,6,0,0,6
John J. Schreiber,0,0,6,0,0,6
"KB Home Greater Los Angeles, Inc.",0,0,6,0,0,6
Lacal Oil Corporation,0,0,6,0,0,6
Ladd Petroleum Corp.,0,0,6,0,0,6
Lawbar Petroleum Inc.,0,0,6,0,0,6
Lebow Oil Company,0,0,6,0,0,6
"Len Owens, Oper.",0,0,6,0,0,6
Lomita Operating Co.,0,0,6,0,0,6
Main and Yorktown LLC,0,0,6,0,0,6
Mar-Roo Syndicate,0,0,6,0,0,6
Marina Pacifica Oil Company,0,0,6,0,0,6
McCray Bros,0,0,6,0,0,6
"Meritage Homes of California, Inc.",0,0,6,0,0,6
"Midland Oilfields Co., Ltd.",0,0,6,0,0,6
Miller and York Oil Operations,0,0,6,0,0,6
Miller Drilling Co.,0,0,6,0,0,6
"Mobil Oil Exploration & Production North America, Inc., Unit Operator",0,0,6,0,0,6
Montara Petro. Co.,0,0,6,0,0,6
Norbel Oil Company,0,0,6,0,0,6
Oregon Natl. Gas Dev. Corp.,0,0,6,0,0,6
P. S. R. & Associates,0,0,6,0,0,6
Pacific Central Oil Company,0,0,6,0,0,6
Paul Graham Drilling & Service Co.,0,0,6,0,0,6
Pongratz Petroleum Co.,0,0,6,0,0,6
Prima Oil Corp.,0,0,6,0,0,6
R. E. Frasch - Jasmin,0,0,6,0,0,6
Revo Oil Co.,0,0,6,0,0,6
Richard Young & Associates,0,0,6,0,0,6
Robert D. Vigue,0,0,6,0,0,6
Robert Sumpf,0,0,6,0,0,6
Roy Gill & Assoc.,0,0,6,0,0,6
Russell Oil Co.,0,0,6,0,0,6
San Carlos Oil & Gas Corp.,0,0,6,0,0,6
"San Joaquin Drilling Co., Inc.",0,0,6,0,0,6
Shepard Oil Corp.,0,0,6,0,0,6
Simi Oil Co.,0,0,6,0,0,6
"Sojitz Energy Venture, Inc.",0,0,6,0,0,6
South Bay Oil Development Co.,0,0,6,0,0,6
Southridge Homes,0,0,6,0,0,6
"Summit Exploration (California), LLC",0,0,6,0,0,6
Sunrise Resources Inc.,0,0,6,0,0,6
T. G. Ross,0,0,6,0,0,6
"Texalta Oil And Gas, Inc.",0,0,6,0,0,6
Texas Pacific Coal & Oil Co.,0,0,6,0,0,6
"Texas Pacific Oil Company, Inc.",0,0,6,0,0,6
"The Elmer Company, Ltd.",0,0,6,0,0,6
The Mitchel Co.,0,0,6,0,0,6
"Union Oil Co. of Calif., Opr.",0,0,6,0,0,6
Valley Oil Co.,0,0,6,0,0,6
"Vedder Petroleum Corp., Ltd.",0,0,6,0,0,6
Victor Exploration Co.,0,0,6,0,0,6
Virsal Oil Company,0,0,6,0,0,6
W. P. W. Petroleum Co.,0,0,6,0,0,6
"W. S. Payne, Jr., Oper.",0,0,6,0,0,6
Warren L. Meeker and Russell D. Garner,0,0,6,0,0,6
Westates Petroleum Co,0,0,6,0,0,6
Western Empire Petroleum Co.,0,0,6,0,0,6
Widgeon Land Company,0,0,6,0,0,6
Williams Oil Company,0,0,6,0,0,6
"Wm. R. Whittaker Co., Ltd.",0,0,6,0,0,6
"YLTICEM 2015, LLC",0,0,6,0,0,6
Zenith Oil Co.,0,0,6,0,0,6
"Kem Enterprise, Inc.",5,0,0,0,0,5
"Morrison Oil Co., LLC",5,0,0,0,0,5
Sampson Operators,5,0,0,0,0,5
West Coast Operators Inc.,5,0,0,0,0,5
Black Gold Oil Company,4,1,0,0,0,5
"Energeo Resources, LLC",3,2,0,0,0,5
Krummrich Engineering Corporation,2,3,0,0,0,5
Hoag Memorial Hospital Presbyterian,2,1,2,0,0,5
"Campo Verde Oil, Inc.",2,0,3,0,0,5
Herley-Kelley LLC,1,0,4,0,0,5
J. J. Rekar,0,5,0,0,0,5
James F. Ross,0,5,0,0,0,5
L.A. Pac. Elect. R. R. Co.,0,5,0,0,0,5
"Reserve Petroleum California, Inc.",0,5,0,0,0,5
Thomas R. Banks,0,5,0,0,0,5
Trinitas Oil Co.,0,5,0,0,0,5
W. S. Morgan,0,5,0,0,0,5
"Dos Rios, Inc.",0,4,1,0,0,5
Sagebrush Oil & Gas Co.,0,4,1,0,0,5
Clofas Case Oil Co.,0,3,2,0,0,5
Emil W. Plegel,0,3,2,0,0,5
Golden Gate Oil Co.,0,3,2,0,0,5
John B. Harding,0,3,2,0,0,5
Retsof Drilling Co.,0,3,2,0,0,5
Utah California Consolidated Co.,0,3,2,0,0,5
AA Production Services Inc.,0,2,3,0,0,5
Globe Petroleum Corp.,0,2,3,0,0,5
Joseph B. Dabney,0,2,3,0,0,5
Keating Est.,0,2,3,0,0,5
Mohawk Petro. Co.,0,2,3,0,0,5
R. H. Anderson & C.C. Friend,0,2,3,0,0,5
"Western Oil & Refining Co., Gillis, Rec.",0,2,3,0,0,5
A. N. Macrate,0,1,4,0,0,5
Cypress Petroleum Co. of California,0,1,4,0,0,5
Geo. W. Johnson,0,1,4,0,0,5
Great American Petroleum Co.,0,1,4,0,0,5
Homestake Oil Co.,0,1,4,0,0,5
Louis F. Dekay & Son,0,1,4,0,0,5
M & B Oil Company,0,1,4,0,0,5
Painted Hills Oil Co.,0,1,4,0,0,5
R. B. Jackson,0,1,4,0,0,5
Rincon Oil Co.,0,1,4,0,0,5
Well Water Management,0,1,4,0,0,5
4H Oil Co.,0,0,5,0,0,5
A. A. Cameron,0,0,5,0,0,5
A. W. Brooks Production,0,0,5,0,0,5
Airline Oil Co.,0,0,5,0,0,5
Albercalif Petroleums Ltd.,0,0,5,0,0,5
"Allstate Steel Fabricators, Inc",0,0,5,0,0,5
Amazon Supply Company,0,0,5,0,0,5
American Ventura Oil Co.,0,0,5,0,0,5
Arden D. Danielson,0,0,5,0,0,5
Baker-Dickey Partnership,0,0,5,0,0,5
Balken Corp.,0,0,5,0,0,5
Barney Cornett and Associates,0,0,5,0,0,5
Beach Supply Co.,0,0,5,0,0,5
Bear Mountain Oil Co.,0,0,5,0,0,5
Ben Owens Drilling Co.,0,0,5,0,0,5
Berry Oil Co.,0,0,5,0,0,5
Big Valley Resources,0,0,5,0,0,5
Brooknel Pet Co.,0,0,5,0,0,5
Brown Shasta Oil Co.,0,0,5,0,0,5
Bruce Anderson,0,0,5,0,0,5
Burton W. Hancock,0,0,5,0,0,5
C. B. Cates,0,0,5,0,0,5
"C. L. Fowler, Operator",0,0,5,0,0,5
C. W. Foust,0,0,5,0,0,5
California Div of Highways,0,0,5,0,0,5
Carl W. Grother,0,0,5,0,0,5
Carson Estate Co.,0,0,5,0,0,5
"Cather, Barnes & Cree",0,0,5,0,0,5
Charles Holmes,0,0,5,0,0,5
Cities Service Oil And Gas Co.,0,0,5,0,0,5
Clients Oil Co.,0,0,5,0,0,5
"Coal Oil, Inc.",0,0,5,0,0,5
D. J. Pickrell,0,0,5,0,0,5
D. L. Brown,0,0,5,0,0,5
DAI Petroleum Co.,0,0,5,0,0,5
Daleco Resources,0,0,5,0,0,5
Davidor & Davidor,0,0,5,0,0,5
DEEP Oil Co.,0,0,5,0,0,5
Detterich & Fiske,0,0,5,0,0,5
Devils Den Development Co.,0,0,5,0,0,5
"DKM Offshore Energy, Inc.",0,0,5,0,0,5
DOC Oil Corp.,0,0,5,0,0,5
Donald E Douglas &,0,0,5,0,0,5
"Donald Frankel, Operator",0,0,5,0,0,5
Doyle Petroleum Corporation,0,0,5,0,0,5
Duncan Wharf,0,0,5,0,0,5
"Dynamic Production, Inc.",0,0,5,0,0,5
E. A. Tompkins Co.,0,0,5,0,0,5
E. C. Brown,0,0,5,0,0,5
Earl Robinett,0,0,5,0,0,5
Energetics Operating Co.,0,0,5,0,0,5
Esenjay Petroleum Corporation,0,0,5,0,0,5
Estate of A. H. Bradford,0,0,5,0,0,5
Estate of George Cantor,0,0,5,0,0,5
"Evans & Carey, Inc.",0,0,5,0,0,5
F. R. Bartee,0,0,5,0,0,5
G R Scott,0,0,5,0,0,5
G. Graham,0,0,5,0,0,5
Garner-Lange Oil Co.,0,0,5,0,0,5
Gateway Petroleum,0,0,5,0,0,5
General Crude Oil Co. Opr.,0,0,5,0,0,5
General Expl. Co. of Ca,0,0,5,0,0,5
Greene-Howard Petro. Corp.,0,0,5,0,0,5
Gus Ninkovich,0,0,5,0,0,5
Guy N. Stafford,0,0,5,0,0,5
H & O Oil Co.,0,0,5,0,0,5
H. I. Day (Mrs.),0,0,5,0,0,5
H. L. Alexander & Glenn J. Homan,0,0,5,0,0,5
Haynes Oil & Gas Co.,0,0,5,0,0,5
Hickory-National Co.,0,0,5,0,0,5
"Howard H. Bell, Jr.",0,0,5,0,0,5
InStrat Inc.,0,0,5,0,0,5
International Oil & Mining,0,0,5,0,0,5
Intex Oil Company,0,0,5,0,0,5
J. D. Martin,0,0,5,0,0,5
J. H. Marion,0,0,5,0,0,5
J. L. Davis,0,0,5,0,0,5
James H. McCue,0,0,5,0,0,5
Jesse R. Schones,0,0,5,0,0,5
John H. Beach,0,0,5,0,0,5
Joseph N. Shaffer,0,0,5,0,0,5
"Kaiser Energy, Inc.",0,0,5,0,0,5
"Kent Organizations, Inc.",0,0,5,0,0,5
KLD Energy,0,0,5,0,0,5
L. C. & M. V. Kelly Oil Prod,0,0,5,0,0,5
"L. H. Scott Co., Inc.",0,0,5,0,0,5
Lake Oil Co.,0,0,5,0,0,5
"Lear Petroleum Exploration, Inc.",0,0,5,0,0,5
"Lewis Solomon, Operator",0,0,5,0,0,5
Linda U. Coulter,0,0,5,0,0,5
Long Beach Oil Development Co.,0,0,5,0,0,5
Los Flores Land & Oil Co.,0,0,5,0,0,5
Louis A. Galasso,0,0,5,0,0,5
LTSC Community Development Corporation,0,0,5,0,0,5
Lubricating Oil Co.,0,0,5,0,0,5
M. R. Peck & Sons,0,0,5,0,0,5
Magnum Resources Corp.,0,0,5,0,0,5
Manhattan Consolidated Mines Development Co.,0,0,5,0,0,5
Marvel Oil Co.,0,0,5,0,0,5
"Max Pray & Elisha Walker, Jr.",0,0,5,0,0,5
"Maxim Resources Ltd, U.S.A.",0,0,5,0,0,5
McCarthy Oil & Gas Corp.,0,0,5,0,0,5
Medley Oil & Gas,0,0,5,0,0,5
Midge Oil Co.,0,0,5,0,0,5
"Miller and York, Inc.",0,0,5,0,0,5
Mola Development Corp.,0,0,5,0,0,5
Morton & Elder,0,0,5,0,0,5
National Petroleum Finance Corp.,0,0,5,0,0,5
Ned Barmore,0,0,5,0,0,5
Nicolai & Hamilton,0,0,5,0,0,5
Onesta Corp.,0,0,5,0,0,5
Osage Oil & Gas Corp.,0,0,5,0,0,5
Packard Petro. Corp.,0,0,5,0,0,5
Palm Petroleum Corp,0,0,5,0,0,5
Phillip & Phyllis Pace-Trustee,0,0,5,0,0,5
Piru Oil and Land Co.,0,0,5,0,0,5
Q. R. Grenfell & Son,0,0,5,0,0,5
Quality Oil Corp.,0,0,5,0,0,5
R. B. Watkins & Franwin Oil,0,0,5,0,0,5
R. Bruce Grey,0,0,5,0,0,5
"R. E. Doherty, Jr.",0,0,5,0,0,5
"R. F. Oakes, F. W. Combs, et al",0,0,5,0,0,5
Reichhold Energy Corp.,0,0,5,0,0,5
Reno Lanfranco,0,0,5,0,0,5
Resources Investment Corp.,0,0,5,0,0,5
Rio Hondo Oil co.,0,0,5,0,0,5
Rosie E. Doe,0,0,5,0,0,5
Royal Petroleum Company,0,0,5,0,0,5
Russell Giffen,0,0,5,0,0,5
Safeway Oil Co.,0,0,5,0,0,5
San Marino Oil Company,0,0,5,0,0,5
"Senate Res., Inc.",0,0,5,0,0,5
Shriners Hospital for Crippled Children,0,0,5,0,0,5
Southbay Oil Dev. Inc.,0,0,5,0,0,5
"Stansbury, Inc.",0,0,5,0,0,5
Star Oil Co.,0,0,5,0,0,5
State Consolidated Oil Co.,0,0,5,0,0,5
Stinnett Oil Company,0,0,5,0,0,5
Sullivan Oil Service,0,0,5,0,0,5
Synergy Resources,0,0,5,0,0,5
T & E Drilling Co.,0,0,5,0,0,5
T Oil Company,0,0,5,0,0,5
T. &. M Petro. Co.,0,0,5,0,0,5
"Tenneco West, Inc.",0,0,5,0,0,5
"Terra Resources, Inc.",0,0,5,0,0,5
Texas Crude Energy Inc.,0,0,5,0,0,5
Texas Independent Oil Company,0,0,5,0,0,5
"Texpro, Inc.",0,0,5,0,0,5
"The American Metal Co., Ltd",0,0,5,0,0,5
The Fundamental Oil Corp.,0,0,5,0,0,5
The Oil Tool Corp.,0,0,5,0,0,5
The State Co.,0,0,5,0,0,5
Thomas F. Joyce,0,0,5,0,0,5
"Thomas Kelly & Sons, Inc.",0,0,5,0,0,5
Transcon Oil Well Service,0,0,5,0,0,5
Transport Oil Co.,0,0,5,0,0,5
Turner Petro. Co.,0,0,5,0,0,5
U. S. Navy,0,0,5,0,0,5
United Oil Co.,0,0,5,0,0,5
Ventura Oil Co.,0,0,5,0,0,5
Vintage-Omniferous 1st Jt. Ven,0,0,5,0,0,5
W. J. Carter,0,0,5,0,0,5
W. K. Co.,0,0,5,0,0,5
W. M. Killingsworth,0,0,5,0,0,5
Western Well Pulling Co.,0,0,5,0,0,5
White Shield Oil and Gas Corp.,0,0,5,0,0,5
Whittier Assoc.,0,0,5,0,0,5
William E. Butler,0,0,5,0,0,5
Windes Well Service,0,0,5,0,0,5
"Wood-Callahan Oil Co., Ltd., Operator",0,0,5,0,0,5
York Petroleum Co.,0,0,5,0,0,5
"Guzman Energy, Inc.",4,0,0,0,0,4
Protho Energy Service LLC,4,0,0,0,0,4
"SM&O, LLC",4,0,0,0,0,4
"C. E. Allen Co., Inc.",2,2,0,0,0,4
"Golden Valley Energy, LLC",1,2,1,0,0,4
Alexander Oil Co.,1,1,2,0,0,4
U. S. Geological Survey,1,1,2,0,0,4
Petroprize,1,0,3,0,0,4
A. D. Reese,0,4,0,0,0,4
Binion Exploration & Development,0,4,0,0,0,4
Community Oil Well,0,4,0,0,0,4
Consolidated Crude Oil Co.,0,4,0,0,0,4
"Crazy J Oil, LLC",0,4,0,0,0,4
Gordon Oil Co.,0,4,0,0,0,4
Humphrey Oil Co.,0,4,0,0,0,4
John Alton,0,4,0,0,0,4
Kenneth Lopez and Conway Lopez,0,4,0,0,0,4
"OXY Long Beach, Inc.",0,4,0,0,0,4
"1350 Court Partners, LP",0,3,1,0,0,4
Anterra Services Inc.,0,3,1,0,0,4
Crusaders Oil,0,3,1,0,0,4
Gilbert H. Beesemyer,0,3,1,0,0,4
"Lynnhart Company, Inc.",0,3,1,0,0,4
"Miocene Operating Services, Inc",0,3,1,0,0,4
Newport Petro. Corp.,0,3,1,0,0,4
Whitley Oil Refining Co.,0,3,1,0,0,4
1301 Colton LLC,0,2,2,0,0,4
Boswell Petroleum Co.,0,2,2,0,0,4
Central Oil Co.,0,2,2,0,0,4
Dabney Oil Syndicate,0,2,2,0,0,4
Featherstone & Preston Inc.,0,2,2,0,0,4
Liberty Oil Co.,0,2,2,0,0,4
McKeon Oil Co.,0,2,2,0,0,4
Panama-Belridge,0,2,2,0,0,4
Paul E. Olsen & Sons,0,2,2,0,0,4
Tapo Oil Co.,0,2,2,0,0,4
Whittier Fillmore Oil Co.,0,2,2,0,0,4
Adelanto Development Corp.,0,1,3,0,0,4
"Arrowhead Oil Co., Ltd.",0,1,3,0,0,4
Buckeye Union Oil Co.,0,1,3,0,0,4
Camarillo Ref. & Petro. Co.,0,1,3,0,0,4
Felix Mallon,0,1,3,0,0,4
Framac Oil Co.,0,1,3,0,0,4
J.C. and Dorothy A. Bearden,0,1,3,0,0,4
Merchants Petroleum Co.,0,1,3,0,0,4
Mrs. Juanita C. Yorba,0,1,3,0,0,4
Severns Drilling Co.,0,1,3,0,0,4
Signal Oil and Gas Company,0,1,3,0,0,4
Summit Oil Co.,0,1,3,0,0,4
Western Pacific Oil Co.,0,1,3,0,0,4
Rincon Island Limited Partnership,0,1,2,1,0,4
"888-5 Partners, LLC",0,0,4,0,0,4
"A. C. Marion, Trustee",0,0,4,0,0,4
A. D. Mitchell,0,0,4,0,0,4
A. F. Ackerman,0,0,4,0,0,4
Advanced Production Serv.,0,0,4,0,0,4
"Airline Oil Company, Inc.",0,0,4,0,0,4
Albert L. Gibson,0,0,4,0,0,4
Amerada Petroleum Corporation,0,0,4,0,0,4
"Anchor Petroleum, Inc.",0,0,4,0,0,4
Ancora Corp.,0,0,4,0,0,4
Arthur C. Fisher,0,0,4,0,0,4
"Artnell Oil & Gas Co., Inc.",0,0,4,0,0,4
Arvin Associates,0,0,4,0,0,4
Asdoorian-Kotoian,0,0,4,0,0,4
"Ashland Oil, Inc.",0,0,4,0,0,4
Austin Oil Company,0,0,4,0,0,4
"B & D Energy, Inc.",0,0,4,0,0,4
Badger Oil Corp.,0,0,4,0,0,4
Bank Exploration,0,0,4,0,0,4
Bank of Calif/Dortha B. Lewis,0,0,4,0,0,4
Banks and Hansmeyer,0,0,4,0,0,4
"Barnwell Industries, Inc.",0,0,4,0,0,4
Bayshore-Long Beach LLC,0,0,4,0,0,4
"Bechtel Petroleum Operations, Inc.",0,0,4,0,0,4
"Bercon, Inc.",0,0,4,0,0,4
"Bern Oil Co., Ltd.",0,0,4,0,0,4
Bob Webber Drilling Co.,0,0,4,0,0,4
"Bonanni Development Company IV, LLC",0,0,4,0,0,4
Bradford & Plegel,0,0,4,0,0,4
"Bradford Bishop, Operator",0,0,4,0,0,4
Brandt Investment Co.,0,0,4,0,0,4
"Brayton-La Honda, Ltd.",0,0,4,0,0,4
Bush Oil Co.,0,0,4,0,0,4
C. H. Chamberlin,0,0,4,0,0,4
C. O. Rodabaugh,0,0,4,0,0,4
C. S. Smith,0,0,4,0,0,4
Campbell Energy Corp.,0,0,4,0,0,4
"Camtex Industries, Inc.",0,0,4,0,0,4
Cann & Wallis,0,0,4,0,0,4
Carl's Producing Co.,0,0,4,0,0,4
Carl W. Weller,0,0,4,0,0,4
Carlsberg Petroleum Corp,0,0,4,0,0,4
Cayman Corporation,0,0,4,0,0,4
Cemco Oil Corp.,0,0,4,0,0,4
Charles C. Carrillo & Chris B. Pedersen,0,0,4,0,0,4
"Charles T. McCowin, Jr.",0,0,4,0,0,4
Chino Hills Oil Co.,0,0,4,0,0,4
City of Los Angeles Dept. Water & Power,0,0,4,0,0,4
Colonia Oil,0,0,4,0,0,4
Community Oil Producers,0,0,4,0,0,4
Consolidated Petro. Co.,0,0,4,0,0,4
"Continental Trading International, Inc.",0,0,4,0,0,4
Corwin Drilling Company,0,0,4,0,0,4
Coulter Petroleum,0,0,4,0,0,4
Court Hill LA LP,0,0,4,0,0,4
Courtland City Lights Assoc.,0,0,4,0,0,4
"Coyote Oil Company., Ltd.",0,0,4,0,0,4
Crest Oil Co.,0,0,4,0,0,4
D. D. Dunlap and Dorothy Dunlap,0,0,4,0,0,4
"D. W. Elliott, Operating Acct",0,0,4,0,0,4
Daniel B. Robinett,0,0,4,0,0,4
David Radcliff,0,0,4,0,0,4
Davis-Smith,0,0,4,0,0,4
Delaware Northwest Exploration Co.,0,0,4,0,0,4
"Denali Oil & Gas Management, LLC",0,0,4,0,0,4
Diamond Shamrock Expl. Co.,0,0,4,0,0,4
Diamond Valley Oil Co.,0,0,4,0,0,4
Dixie National Oil Co.,0,0,4,0,0,4
Domestic Oil Corp.,0,0,4,0,0,4
Douglas Oil Company of California,0,0,4,0,0,4
"Dover Fiduciary Corp., Oper.",0,0,4,0,0,4
Dumm Bros. Petroleum Corp.,0,0,4,0,0,4
"E. B. Hougham, Operator",0,0,4,0,0,4
E. S. Arnn,0,0,4,0,0,4
Ed Green,0,0,4,0,0,4
Eddie Fisher,0,0,4,0,0,4
Edward Lustgarten,0,0,4,0,0,4
Enos Oil Co.,0,0,4,0,0,4
Era Gill & Assoc.,0,0,4,0,0,4
Eureka Crude Oil Co.,0,0,4,0,0,4
F. D. Davison,0,0,4,0,0,4
"F. H. Gillespie, Jr.",0,0,4,0,0,4
"F. M. Taylor, Operator",0,0,4,0,0,4
"Fairbanks and Haas, Inc.",0,0,4,0,0,4
Fairco Drilling and Development Company,0,0,4,0,0,4
Flanders and Brown,0,0,4,0,0,4
"Fred Gill & Sons, Inc.",0,0,4,0,0,4
Fred M. Riedman,0,0,4,0,0,4
General American Oil Company of Texas,0,0,4,0,0,4
Geo. Terry Drilling Co.,0,0,4,0,0,4
"Geothermal Resources International, Inc.",0,0,4,0,0,4
Gilles De Flon,0,0,4,0,0,4
Glen H. Mitchel,0,0,4,0,0,4
Greevue Corp.,0,0,4,0,0,4
H. H. & W. Oil Co.,0,0,4,0,0,4
H. H. Bell,0,0,4,0,0,4
H. Rambke,0,0,4,0,0,4
H. T. Davis,0,0,4,0,0,4
H. T. Hilliard,0,0,4,0,0,4
Hathaway Co.,0,0,4,0,0,4
Headington Oil Company,0,0,4,0,0,4
Henry E. Dawson,0,0,4,0,0,4
Henry L. Kuns,0,0,4,0,0,4
Highlands Energy Corporation,0,0,4,0,0,4
Hilo Oil Company,0,0,4,0,0,4
Hudson Gas & Oil Corp.,0,0,4,0,0,4
Huntington Beach Assoc.,0,0,4,0,0,4
Indian Petroleum Company,0,0,4,0,0,4
International Exploration Co.,0,0,4,0,0,4
Ione Petro. Co.,0,0,4,0,0,4
Irex Corp.,0,0,4,0,0,4
"J. Ainslie Bell, Operator",0,0,4,0,0,4
J. Berger,0,0,4,0,0,4
J. J. Baker,0,0,4,0,0,4
Jack Herley and Paul L. Kelley,0,0,4,0,0,4
"James B. McDonald, Oper.",0,0,4,0,0,4
James C. Thomas III,0,0,4,0,0,4
James Cagney-Wm. Cagney,0,0,4,0,0,4
James Ebert,0,0,4,0,0,4
James R. Cox,0,0,4,0,0,4
Jasperson & Hunter Oil Prod.,0,0,4,0,0,4
Joel S. C. Brown,0,0,4,0,0,4
"John N. Dewitt, Operator",0,0,4,0,0,4
K. C. Wallace,0,0,4,0,0,4
Kalco Development Corporation,0,0,4,0,0,4
Kay Oil Co.,0,0,4,0,0,4
"Kenneth H. Hunter Jr., Opr.",0,0,4,0,0,4
Kern Co. Drilling Co.,0,0,4,0,0,4
Kettleman North Dome Association,0,0,4,0,0,4
L. A. Messmer,0,0,4,0,0,4
Lamb Oil Co.,0,0,4,0,0,4
"Lawrence Barker, Jr",0,0,4,0,0,4
Lebow-McNee Oil Co.,0,0,4,0,0,4
Lido Petro. Co.,0,0,4,0,0,4
Linc-Wilmington Apts LP,0,0,4,0,0,4
Long & Hedges,0,0,4,0,0,4
Longden Petroleum Co.,0,0,4,0,0,4
Loren L. Hillman,0,0,4,0,0,4
Louis H. Didier,0,0,4,0,0,4
Luard Corp.,0,0,4,0,0,4
M. R. M. Syndicate,0,0,4,0,0,4
Mabee Oil & Gas Co.,0,0,4,0,0,4
Macrate Oil Co. and Dumm Bros. Pet. Corp.,0,0,4,0,0,4
Marcoux Oil Co.,0,0,4,0,0,4
Maria L. Andrade,0,0,4,0,0,4
Mattco Petroleum,0,0,4,0,0,4
May Petroleum Inc.,0,0,4,0,0,4
McVicar-Rood Montebello Ltd.,0,0,4,0,0,4
Meeker and Garner,0,0,4,0,0,4
"Merril J. Brown, Operator",0,0,4,0,0,4
Michigan Oil Company,0,0,4,0,0,4
Mitchell G. Kovaleski,0,0,4,0,0,4
Modoc Petroleum Corp.,0,0,4,0,0,4
Montebello Oil Co.,0,0,4,0,0,4
Myron R. Conn & Assoc.,0,0,4,0,0,4
Nareco Corp.,0,0,4,0,0,4
Natoma Oil Co.,0,0,4,0,0,4
New Century Oil Co.,0,0,4,0,0,4
NHK Oil Co.,0,0,4,0,0,4
Nw Syn. & Brit.-Amer. Oil Prod,0,0,4,0,0,4
Oakburn Drilling Co.,0,0,4,0,0,4
"Oilexco, Inc.",0,0,4,0,0,4
Oleksandr Antonyuk,0,0,4,0,0,4
P. and S. Oil Company,0,0,4,0,0,4
"Pacific Coast Exploration, LLC",0,0,4,0,0,4
Pacific Oil Investment Co. Ltd.,0,0,4,0,0,4
"Pacific Petroleum Technology, LLC",0,0,4,0,0,4
"Pan Petroleum Company, Inc.",0,0,4,0,0,4
Paul Benz,0,0,4,0,0,4
Paul E. Olson,0,0,4,0,0,4
Paul J. Kovar,0,0,4,0,0,4
Peter Delis,0,0,4,0,0,4
Peter W. Hummel & E. D. Neuhoff,0,0,4,0,0,4
Petroleum Corp. of America,0,0,4,0,0,4
"Pexco, Inc.",0,0,4,0,0,4
Philadelphia Oil Co. of Calif.,0,0,4,0,0,4
Prima Oil & Gas Company,0,0,4,0,0,4
"Professional Oil Management, Inc.",0,0,4,0,0,4
Progressive Oil Co.,0,0,4,0,0,4
"R. B. Watkins, Operator",0,0,4,0,0,4
"R. D. Sawyer, Operator",0,0,4,0,0,4
"R. E. Hibbert, Operator",0,0,4,0,0,4
R. K. Cross,0,0,4,0,0,4
R. L. Burns Corp.,0,0,4,0,0,4
R. W. Rhodabarger,0,0,4,0,0,4
R. W. Shull,0,0,4,0,0,4
Radium Oil Co.,0,0,4,0,0,4
Rainbow Oil Co,0,0,4,0,0,4
Recruit Oil Co.,0,0,4,0,0,4
"Republic Operator, Inc.",0,0,4,0,0,4
Rice Ranch Oil Co.,0,0,4,0,0,4
Ridge Oil Co.,0,0,4,0,0,4
Robert A. Cohan,0,0,4,0,0,4
"Robert W. Lee, Investments",0,0,4,0,0,4
"Russell H. Green, Jr.",0,0,4,0,0,4
"S & D Energy Associates, Inc.",0,0,4,0,0,4
Sabra Vista Oil Co.,0,0,4,0,0,4
Sampson Oil Partnership,0,0,4,0,0,4
Sanchez-O'Brien Minerals Corporation,0,0,4,0,0,4
Santa Clarita Watershed Rec.& Cons. Auth.,0,0,4,0,0,4
Searoad Asphaltum & Refining,0,0,4,0,0,4
Security Fore Corp.,0,0,4,0,0,4
"Shepherd-Robertson, Inc.",0,0,4,0,0,4
"Sierra Mineral Development, L.C.",0,0,4,0,0,4
Southern Exploration Company,0,0,4,0,0,4
Soverign Oil Corp.,0,0,4,0,0,4
Standard Oil Company of California,0,0,4,0,0,4
Street Oil Co.,0,0,4,0,0,4
Stuart Oil Co.,0,0,4,0,0,4
"Tad Travers, Operator",0,0,4,0,0,4
Tecumsah Petro. Co.,0,0,4,0,0,4
"Ted Koble, Operator",0,0,4,0,0,4
"Ted Sterling, Operator",0,0,4,0,0,4
"Texas Crude Exploration, Inc.",0,0,4,0,0,4
The Major Oil Corp.,0,0,4,0,0,4
The Superior Oil Company and Independent Exploration Co.,0,0,4,0,0,4
The United Oil Company,0,0,4,0,0,4
Thos. M. Blake,0,0,4,0,0,4
Time Petro. Co.,0,0,4,0,0,4
Torrey Petrolum Co.,0,0,4,0,0,4
U. S. Natural Gas Corporation,0,0,4,0,0,4
United Exploration Co. of Calif.,0,0,4,0,0,4
"V O D Oil Co., Inc.",0,0,4,0,0,4
Vi-Roi Oil Co.,0,0,4,0,0,4
"Victory Oil Co., Oper",0,0,4,0,0,4
Volunteer Petro. Co.,0,0,4,0,0,4
"W. B. Osborn, Jr.",0,0,4,0,0,4
"W. C. Thompson, Gas & Oil Expl.",0,0,4,0,0,4
W. E. Strangman,0,0,4,0,0,4
W. R. Boatman,0,0,4,0,0,4
W. T. Jacobs,0,0,4,0,0,4
W. W. Holmes & Assoc.,0,0,4,0,0,4
W. Y. Lee,0,0,4,0,0,4
Walter P. Temple Oil Co.,0,0,4,0,0,4
Washington Coalinga Oil Co.,0,0,4,0,0,4
"Watkins and Dolley, Operators",0,0,4,0,0,4
Wesley H. Colquitt,0,0,4,0,0,4
West Huasna Oil Co.,0,0,4,0,0,4
Westates Expl. Co.,0,0,4,0,0,4
Western Avenue Properties,0,0,4,0,0,4
White Knight Production LLC,0,0,4,0,0,4
William Gilmore,0,0,4,0,0,4
William H. Hudson,0,0,4,0,0,4
Wm. A. Bartholomae,0,0,4,0,0,4
"Woodward Oil Company, Ltd.",0,0,4,0,0,4
Wucherer-Gray Oil Co. Consolidated,0,0,4,0,0,4
York Oil Co.,0,0,4,0,0,4
"Zack Tatum, Oil and Gas Producer",0,0,4,0,0,4
Zoraida B. Travis,0,0,4,0,0,4
Glendale Oil LLC,3,0,0,0,0,3
"Grapevine Energy, LLC",3,0,0,0,0,3
Maya Oil LLC,3,0,0,0,0,3
Taft College,3,0,0,0,0,3
"John O. Richardson, Operator",2,1,0,0,0,3
"Midstream Energy Partners (USA), LLC",2,1,0,0,0,3
"Aalpha Energy, Inc.",2,0,1,0,0,3
Central Valley Waste Water LLC,2,0,1,0,0,3
"El Segundo Oil, LLC",2,0,1,0,0,3
"Hoyt Energy, L.L.C.",2,0,1,0,0,3
Hunt Enterprises,1,0,2,0,0,3
104 Oil & Drilling Co.,0,3,0,0,0,3
B.G.T. Oil Co.,0,3,0,0,0,3
Baldwin-Stocker Oil Estates,0,3,0,0,0,3
Bob Smith,0,3,0,0,0,3
C. J. George,0,3,0,0,0,3
Clarence R. Barnett Inc.,0,3,0,0,0,3
Combined Oil & Land Co.,0,3,0,0,0,3
D. H. Wood,0,3,0,0,0,3
Daily Oil Co.,0,3,0,0,0,3
Dennis C. Franks,0,3,0,0,0,3
Dentino Oil Company Inc.,0,3,0,0,0,3
Dolke-Thomas Oil Synd.,0,3,0,0,0,3
Dwyer-Lisbon Ranch,0,3,0,0,0,3
Fred Cagle,0,3,0,0,0,3
Hitchcock & Ort,0,3,0,0,0,3
Huntington & Northern Petro. Co.,0,3,0,0,0,3
Kreyenhagen Oil Co.,0,3,0,0,0,3
L. R. Clark,0,3,0,0,0,3
Locators' Oil Co.,0,3,0,0,0,3
Mentren Corporation,0,3,0,0,0,3
Mrs. J. Alderson,0,3,0,0,0,3
Murrietta,0,3,0,0,0,3
Mutual Benefit Oil Co.,0,3,0,0,0,3
Newport Bay Oil Co.,0,3,0,0,0,3
O. McKernan,0,3,0,0,0,3
Off Crude Oil Co.,0,3,0,0,0,3
"Pacific Energy Resources, Inc.",0,3,0,0,0,3
Parkman Oil Co.,0,3,0,0,0,3
Pennsylvania Oil Co.,0,3,0,0,0,3
Port Orange Asphalt Co.,0,3,0,0,0,3
"Quadren Cryogenic Process, Ltd.",0,3,0,0,0,3
"Redbank Oil Co., Operator",0,3,0,0,0,3
Richard Green,0,3,0,0,0,3
Rommell Oil Co.,0,3,0,0,0,3
"Swag Oil Co., Inc.",0,3,0,0,0,3
The Lewy Family Trust,0,3,0,0,0,3
Traders Oil Co.,0,3,0,0,0,3
"Victoria Petroleum USA, Inc.",0,3,0,0,0,3
Whittier Utility Authority,0,3,0,0,0,3
A. M. Brown Kettleman City Oil & Gas Co.,0,2,1,0,0,3
Black Eagle Oil Corp,0,2,1,0,0,3
Chino Land & Water Co.,0,2,1,0,0,3
E. R. Rich,0,2,1,0,0,3
Edward L. Grafton,0,2,1,0,0,3
"Elk Hills Power, LLC",0,2,1,0,0,3
Hewitt-Woolsey,0,2,1,0,0,3
Imperial Occidental,0,2,1,0,0,3
J. C. Theriot,0,2,1,0,0,3
J. T. Robertson Co.,0,2,1,0,0,3
Jesse M. Nelson Co.,0,2,1,0,0,3
John Tedesco,0,2,1,0,0,3
Kansas Crude Co.,0,2,1,0,0,3
McDor Co.,0,2,1,0,0,3
Phalen & Holford,0,2,1,0,0,3
"R. H. Alexander, Jr.",0,2,1,0,0,3
Resources Engineering,0,2,1,0,0,3
Ring Exploration Co.,0,2,1,0,0,3
The 2020 Macmillan and Peterson Family Revocable Trust,0,2,1,0,0,3
W. Saunders,0,2,1,0,0,3
A. Otis Birch,0,1,2,0,0,3
"Anterra Energy Services, Inc.",0,1,2,0,0,3
Big Basin Dev. Co.,0,1,2,0,0,3
"Borderland Exploration Co., Inc.",0,1,2,0,0,3
Doherty Oil,0,1,2,0,0,3
Dominguez Extension Oil Co.,0,1,2,0,0,3
E. E. Combs Business Trust No. 3,0,1,2,0,0,3
Estate of A. B. Cross,0,1,2,0,0,3
Estate of Thomas L. Hannah,0,1,2,0,0,3
H. A. Bardeen,0,1,2,0,0,3
H. L. Kitselman,0,1,2,0,0,3
"Hammond Canyon I, Inc.",0,1,2,0,0,3
Hanna Oil Co.,0,1,2,0,0,3
Jackson Oil,0,1,2,0,0,3
L & M Oil Co.,0,1,2,0,0,3
Melvin Hansen,0,1,2,0,0,3
Mohawk Oil Co.,0,1,2,0,0,3
Nixon & Bosig,0,1,2,0,0,3
North Counties Oil Co.,0,1,2,0,0,3
Rio Virgin Oil Co.,0,1,2,0,0,3
Santa Ana Oil Co.,0,1,2,0,0,3
Smith & Graham,0,1,2,0,0,3
Smith Petroleum Co.,0,1,2,0,0,3
South Slope Oil Co.,0,1,2,0,0,3
Sun Oil Co. of California,0,1,2,0,0,3
W. W. Bush,0,1,2,0,0,3
Martin & Dudley,0,1,1,0,1,3
1211 S. Olive Street Development LP,0,0,3,0,0,3
"1355 Operator, LLC",0,0,3,0,0,3
"950 Stadium Way Buyer, LLC",0,0,3,0,0,3
A. Bruce Frame,0,0,3,0,0,3
A. D. Rushing Inc.,0,0,3,0,0,3
A. H. Trester & Doris D. Trester,0,0,3,0,0,3
"A. L. Hunter, Oper.",0,0,3,0,0,3
"A. M. Hammerslough, Operator",0,0,3,0,0,3
A. T. Jergins Trust,0,0,3,0,0,3
A.E. Schulze,0,0,3,0,0,3
"AFP, LLC",0,0,3,0,0,3
Al Godfrey Drilling Co.,0,0,3,0,0,3
Alco Oil and Gas Corporation,0,0,3,0,0,3
Alma Oil Company,0,0,3,0,0,3
"Alpine Oil Company, Inc.",0,0,3,0,0,3
"Alta Petroleum, Inc.",0,0,3,0,0,3
American Drilling Co.,0,0,3,0,0,3
American Oil Service,0,0,3,0,0,3
American Petrofina Co. of Texas,0,0,3,0,0,3
Anne Arnold,0,0,3,0,0,3
"Ansbro Petroleum Company, LLC",0,0,3,0,0,3
"Anthony J. Kennedy, Oper.",0,0,3,0,0,3
Ardly Petro. Co.,0,0,3,0,0,3
Aristata Exploration Co.,0,0,3,0,0,3
Armstrong Exploration,0,0,3,0,0,3
"Armstrong Oil, Inc.",0,0,3,0,0,3
B-N Dev. Corp.,0,0,3,0,0,3
"B. B. Beckenridge, Oper.",0,0,3,0,0,3
B. B. Breckenridge,0,0,3,0,0,3
B. H. Richards,0,0,3,0,0,3
B. L. T. Oil Co.,0,0,3,0,0,3
B. Pete Jackson,0,0,3,0,0,3
"Bakersfield Energy Resources, Inc.",0,0,3,0,0,3
Bali Oil Co.,0,0,3,0,0,3
Band Oil Company,0,0,3,0,0,3
Bardeen Oil Co.,0,0,3,0,0,3
"Barham-Boyne Oil Co., Inc.",0,0,3,0,0,3
Barnwell Drilling Co. Inc.,0,0,3,0,0,3
Bartlow-Hetman Oil Dev.,0,0,3,0,0,3
Baumgartner Oil Co.,0,0,3,0,0,3
"Bay Shore Oil Co., Inc.",0,0,3,0,0,3
Bel-Air Oil Co.,0,0,3,0,0,3
"Ben Leverett, Oper.",0,0,3,0,0,3
Bentley Family Limited Partnership,0,0,3,0,0,3
Bernhard Oil Co.,0,0,3,0,0,3
Bertha C. Needham,0,0,3,0,0,3
Betabel Fruit Farm,0,0,3,0,0,3
Beverly Hills Oil Co.,0,0,3,0,0,3
Beverly Oil Co.,0,0,3,0,0,3
Beverly Trading & Exploration Co.,0,0,3,0,0,3
"Big Valley Expl., Inc.",0,0,3,0,0,3
Bird Oil Corporation,0,0,3,0,0,3
Bishop Oil & Gas Properties,0,0,3,0,0,3
Blue Diamond Oil Co.,0,0,3,0,0,3
"Bob Spreen, Oper.",0,0,3,0,0,3
"Bobby Burns Petro., Inc.",0,0,3,0,0,3
Bomke and Ball,0,0,3,0,0,3
Bradford Bros. Inc.,0,0,3,0,0,3
Brea Oil Co.,0,0,3,0,0,3
"Brea Oil Company, Inc.",0,0,3,0,0,3
Brothers Oil Co,0,0,3,0,0,3
BTA Oil Producers,0,0,3,0,0,3
Buckhorn Oil & Mining Co.,0,0,3,0,0,3
Buick Oil,0,0,3,0,0,3
"Bwab, Inc.",0,0,3,0,0,3
C. A. Howard Oil Producing,0,0,3,0,0,3
C. C. Horace,0,0,3,0,0,3
C. C. Loftin,0,0,3,0,0,3
C. D. Cunningham,0,0,3,0,0,3
C. F. Sudduth,0,0,3,0,0,3
C. G. Perry Drilling Co.,0,0,3,0,0,3
C. N. Cake,0,0,3,0,0,3
"C. Ray Robinson, Operator",0,0,3,0,0,3
"CAI Rockwood, LP, a Limited Partnership",0,0,3,0,0,3
Caliente Oil Company,0,0,3,0,0,3
"California E.D.I., Inc.",0,0,3,0,0,3
California Exploration Inc.,0,0,3,0,0,3
California Star Oil Company,0,0,3,0,0,3
California Western Oil Co.,0,0,3,0,0,3
Carl B. Breig,0,0,3,0,0,3
Carl Maier Syndicate,0,0,3,0,0,3
Carl Weaver Properties,0,0,3,0,0,3
Carol Rhodabarger Heitz,0,0,3,0,0,3
Catellus Valencia LLC,0,0,3,0,0,3
Cayman Expl. Corp.,0,0,3,0,0,3
Celeron Oil & Gas Co.,0,0,3,0,0,3
Cemco-Edison No. 1 (F.R.) Partnership,0,0,3,0,0,3
Charles R. Tatum Oil Producer,0,0,3,0,0,3
Charles W. Heim,0,0,3,0,0,3
"Chino Center, Inc.",0,0,3,0,0,3
Cica Production Co. LLC,0,0,3,0,0,3
Citizens Oil Co.,0,0,3,0,0,3
City of Stockton,0,0,3,0,0,3
CL&E Corporation,0,0,3,0,0,3
Clearfield Energy Resources & Management Inc.,0,0,3,0,0,3
"Clyde B. Baker, Opr.",0,0,3,0,0,3
Coastal Drilling Co.,0,0,3,0,0,3
Coastline Oil Co.,0,0,3,0,0,3
Coffee-Brimhall LLC,0,0,3,0,0,3
"Collins Oil Associates, Inc.",0,0,3,0,0,3
Congress Petroleum Co.,0,0,3,0,0,3
Conservative Petro. Corp. Ltd.,0,0,3,0,0,3
Consolidated Midway Chief Oil Co.,0,0,3,0,0,3
"Consolidated Minerals, Inc.",0,0,3,0,0,3
"Consolidated Resources, Inc.",0,0,3,0,0,3
Coplin and Berryhill,0,0,3,0,0,3
"Crown-Huntington Oils, Ltd.",0,0,3,0,0,3
Cruisend Oil Co.,0,0,3,0,0,3
CSIP WR Santa Fe Springs LLC,0,0,3,0,0,3
D-C Oil Productions,0,0,3,0,0,3
D & E Oil Co.,0,0,3,0,0,3
D. A. Barth,0,0,3,0,0,3
D. A. Hargrave,0,0,3,0,0,3
D. C. Basolo Jr.,0,0,3,0,0,3
Dana Productions Co.,0,0,3,0,0,3
Danald J. Bedell,0,0,3,0,0,3
"Daniel W. Elliott, Jr.",0,0,3,0,0,3
Dauphin Dev. Corp.,0,0,3,0,0,3
Deer Creek Properties,0,0,3,0,0,3
"Deltron Drilling, Inc.",0,0,3,0,0,3
Dickinson-Wadsworth Assoc.,0,0,3,0,0,3
"Dielectric Laboratories, Inc.",0,0,3,0,0,3
Doheny Pacific Petroleum Co.,0,0,3,0,0,3
Dominion Oil Co.,0,0,3,0,0,3
Don Angle,0,0,3,0,0,3
Dr. F. M. Pottenger,0,0,3,0,0,3
Dr. James O. Crittenden,0,0,3,0,0,3
Drake Oil Co,0,0,3,0,0,3
Dunlap & Knapp,0,0,3,0,0,3
Dwight G. Vedder,0,0,3,0,0,3
E B Hall & Co.,0,0,3,0,0,3
E. A. Shamlin,0,0,3,0,0,3
E. E. Fairbanks,0,0,3,0,0,3
E. G. Lewis Oil Devl Ass'n,0,0,3,0,0,3
E. J. Miley,0,0,3,0,0,3
E. L. Cragen,0,0,3,0,0,3
E. R. Bardwell,0,0,3,0,0,3
E. Z. Lopp,0,0,3,0,0,3
Eastern Pacific Oil Co.,0,0,3,0,0,3
"Edgington Oil Refineries, Inc.",0,0,3,0,0,3
Elkern Oil Co.,0,0,3,0,0,3
Elmar Oil Corp.,0,0,3,0,0,3
"Emerich Oil Corporation, Ltd.",0,0,3,0,0,3
Environmental Protection Corp.,0,0,3,0,0,3
Estate of Frank Rice Short,0,0,3,0,0,3
Estate of Paul A. Medearis,0,0,3,0,0,3
Estate of Warren F. McGrath,0,0,3,0,0,3
Eureka Refining Corp.,0,0,3,0,0,3
"Evans, Carey & Crozier",0,0,3,0,0,3
Eyer Brothers,0,0,3,0,0,3
F. A. Burkett and A. D. Moodie,0,0,3,0,0,3
F. Robert Reynolds,0,0,3,0,0,3
Fairhaven Resources,0,0,3,0,0,3
Federal Drilling Co.,0,0,3,0,0,3
Fetterman Oil Co.,0,0,3,0,0,3
Flintridge Oil Co.,0,0,3,0,0,3
Florian Trinajstich,0,0,3,0,0,3
Floyd M. Morris,0,0,3,0,0,3
Flynn Energy Corp.,0,0,3,0,0,3
Fortune Oil Company,0,0,3,0,0,3
Fountain Oil Co.,0,0,3,0,0,3
Fowler and Jones Oil Co,0,0,3,0,0,3
Frank Goldman Operator,0,0,3,0,0,3
Fred A. Miller,0,0,3,0,0,3
Fred L. Williams,0,0,3,0,0,3
Freeman & Nelson White Oil Co.,0,0,3,0,0,3
Freeport Oil Company,0,0,3,0,0,3
"Fresno Expl. Co., Inc.",0,0,3,0,0,3
"Fresno Oil Investment, Inc.",0,0,3,0,0,3
Fresno United Oil Co.,0,0,3,0,0,3
Fullerton Oil Co.,0,0,3,0,0,3
G-W Resources Corp.,0,0,3,0,0,3
G & M Oil Company,0,0,3,0,0,3
"G. L. Stafford, Jr.",0,0,3,0,0,3
"Garner-Jones, Operator",0,0,3,0,0,3
"Gas Producing Enterprises, Inc.",0,0,3,0,0,3
General Drilling Co.,0,0,3,0,0,3
George Duty,0,0,3,0,0,3
George Kahn Operating Co. & Robert W. Lee,0,0,3,0,0,3
George Wolfe,0,0,3,0,0,3
"Gergen Homes, Inc.",0,0,3,0,0,3
Gilbert Applegate,0,0,3,0,0,3
"Gilbert Drilling, Inc.",0,0,3,0,0,3
Globe Exploration Company,0,0,3,0,0,3
Golden Gate Petroleum Co.,0,0,3,0,0,3
Gordon Greene Guiberson Trust,0,0,3,0,0,3
"Grassy Hill Management, Inc.",0,0,3,0,0,3
Gravelle Family Trust,0,0,3,0,0,3
"Grayco Energy Explor., Inc.",0,0,3,0,0,3
Gregory G. Minshall Trust,0,0,3,0,0,3
Gus Pongratz,0,0,3,0,0,3
"Gustafson Brothers, Inc.",0,0,3,0,0,3
H H & W  Exploration Co.,0,0,3,0,0,3
H. E. McLain,0,0,3,0,0,3
"H. F. Dangberg, Operator",0,0,3,0,0,3
Hagar & Deniston,0,0,3,0,0,3
"Harlan Prine, Oper.",0,0,3,0,0,3
Harp & Brown,0,0,3,0,0,3
Harris Investment Corp.,0,0,3,0,0,3
Harry C. Long & Assoc.,0,0,3,0,0,3
"Harry C. Long, Opr.",0,0,3,0,0,3
Harvey F. Nelson,0,0,3,0,0,3
Harvey L. Decker and Spencer Rush,0,0,3,0,0,3
Hearn Co.,0,0,3,0,0,3
Hedges Oil Co.,0,0,3,0,0,3
Helm Co. & Robert Sumpf,0,0,3,0,0,3
Henry Lubking Associates,0,0,3,0,0,3
Henry Lynn Hall,0,0,3,0,0,3
Heritage Oil Company,0,0,3,0,0,3
Hess-Rue-Henderson Oil Co.,0,0,3,0,0,3
"Hillman-Long, Inc.",0,0,3,0,0,3
Hilton Petroleum Inc.,0,0,3,0,0,3
Hogan Realty Co.,0,0,3,0,0,3
Hom Oil Co.,0,0,3,0,0,3
Howard C. Smith,0,0,3,0,0,3
Howard Oil Co.,0,0,3,0,0,3
Howard W. Lindow,0,0,3,0,0,3
Huasna Petro. Co.,0,0,3,0,0,3
Huber E. Myers,0,0,3,0,0,3
Huntington Beach Union High Sc,0,0,3,0,0,3
Huntington Investment,0,0,3,0,0,3
Imperial Oil & Gas Ltd.,0,0,3,0,0,3
Industrial Devel. Assoc.,0,0,3,0,0,3
Inland Petroleum Company,0,0,3,0,0,3
Inter-American Petroleum,0,0,3,0,0,3
Irene Rush Morris,0,0,3,0,0,3
Italo Petroleum Corp. of America,0,0,3,0,0,3
J. A. Lavender,0,0,3,0,0,3
"J. C. Anderson, Trustee",0,0,3,0,0,3
J. E. Pettijohn,0,0,3,0,0,3
J. I. Anderson & So Ca Petr,0,0,3,0,0,3
J. L. Milburn,0,0,3,0,0,3
J. P. Rinde,0,0,3,0,0,3
J. Paul Sievers,0,0,3,0,0,3
Jack C. Roger,0,0,3,0,0,3
Jade Oil & Gas Co.,0,0,3,0,0,3
James A. Gautier,0,0,3,0,0,3
James F. Nugent Oil Co.,0,0,3,0,0,3
JD 6th Street LLC,0,0,3,0,0,3
Jess C. Barnes,0,0,3,0,0,3
Jet Petroleum Co.,0,0,3,0,0,3
Joe Schuck,0,0,3,0,0,3
John B Quinn,0,0,3,0,0,3
John B. Quinn,0,0,3,0,0,3
"John F. Wilcox, Operator",0,0,3,0,0,3
"John M. Young, Operator",0,0,3,0,0,3
John N. Dewitt & Paul Graham,0,0,3,0,0,3
John Pestana Family Trust,0,0,3,0,0,3
John Schumacher,0,0,3,0,0,3
Joseph F. Engeln,0,0,3,0,0,3
Joseph M. Gross,0,0,3,0,0,3
Joshua Oil & Gas,0,0,3,0,0,3
K and M Drilling Co.,0,0,3,0,0,3
"K. R. Evans, Operator",0,0,3,0,0,3
Karl D. Fechner,0,0,3,0,0,3
KC Resources Inc.,0,0,3,0,0,3
Kenco Oil Company,0,0,3,0,0,3
"Kenneth H. Hunter, Jr. (Exploration)",0,0,3,0,0,3
Kenneth King Lowell,0,0,3,0,0,3
"Kestrel Energy of California, Inc.",0,0,3,0,0,3
King Development Company,0,0,3,0,0,3
Kiowa Petro. Corp.,0,0,3,0,0,3
Koch Exploration Company,0,0,3,0,0,3
L. B. Armstrong & Assoc.,0,0,3,0,0,3
"L. C. Enterprises, Inc.",0,0,3,0,0,3
L. H. Miller-Nicolai & Son,0,0,3,0,0,3
Laguna Oil Co.,0,0,3,0,0,3
Lake View Oil Co.,0,0,3,0,0,3
Lakeview-Coalinga Co.,0,0,3,0,0,3
Lamont Oil Co.,0,0,3,0,0,3
Langlois Bros.,0,0,3,0,0,3
Layne Oil Co.,0,0,3,0,0,3
Lebow & Lebow,0,0,3,0,0,3
Lebow & McNee,0,0,3,0,0,3
"Leclair-Westwood, Inc.",0,0,3,0,0,3
Lee Ault & Assoc.,0,0,3,0,0,3
Lee Clayton,0,0,3,0,0,3
Lee Drilling Co.,0,0,3,0,0,3
Len Owens & Assoc.,0,0,3,0,0,3
Leone P. Haslam (Mrs),0,0,3,0,0,3
Lester L. Pedersen,0,0,3,0,0,3
Lewis & Jones Oil Co.,0,0,3,0,0,3
Lewis W. Welch,0,0,3,0,0,3
Lily A. Harris,0,0,3,0,0,3
Lindley C. Morton,0,0,3,0,0,3
Lindsay Community Dev. Assoc.,0,0,3,0,0,3
Loma Alta Oil Co.,0,0,3,0,0,3
Lomita Drilling Co.,0,0,3,0,0,3
Loren A. Davis - Oil Oper.,0,0,3,0,0,3
Luther T. Mayo,0,0,3,0,0,3
Lyle E. Kesselman,0,0,3,0,0,3
Lyon Canyon Oil Corp.,0,0,3,0,0,3
M & G Operating Co.,0,0,3,0,0,3
M and L Oil Company,0,0,3,0,0,3
M. Conniff,0,0,3,0,0,3
M. D. & G. Partnership,0,0,3,0,0,3
M. H. Collins,0,0,3,0,0,3
M. H. Mosier Special,0,0,3,0,0,3
M. J. & O.,0,0,3,0,0,3
M. V. Kahler,0,0,3,0,0,3
MacDonald-Woodward Exploration Co.,0,0,3,0,0,3
Mariel Oil Co.,0,0,3,0,0,3
Marker Foundation Inc.,0,0,3,0,0,3
"Marshall Brown, Oper.",0,0,3,0,0,3
"Martin Shurin, Jr.",0,0,3,0,0,3
Mary Verdonck,0,0,3,0,0,3
Maurice T. Grubb,0,0,3,0,0,3
McKittrick Oil Co.,0,0,3,0,0,3
McWood Corporation,0,0,3,0,0,3
Meigs Estate,0,0,3,0,0,3
Mendocino-Midway Oil Syndicate,0,0,3,0,0,3
Mid Cal Petro. Co.,0,0,3,0,0,3
Midway Fishing Tool Co.,0,0,3,0,0,3
Mike Mikels,0,0,3,0,0,3
Miley Petro. Corp.,0,0,3,0,0,3
Miller and Ford,0,0,3,0,0,3
"Miller and York Oil Operations, Inc.",0,0,3,0,0,3
Mills Oil Co.,0,0,3,0,0,3
"Milon L. Johnston, Opr.",0,0,3,0,0,3
Mitchell Energy Corp.,0,0,3,0,0,3
"MK Operating, LLC",0,0,3,0,0,3
"Morgan Brown, Inc.",0,0,3,0,0,3
Natural Res. Dev. Corp.,0,0,3,0,0,3
NECK Drilling Co.,0,0,3,0,0,3
"Nelson and Cox, Operator",0,0,3,0,0,3
Newmo Company,0,0,3,0,0,3
Newton Dev. Co.,0,0,3,0,0,3
Norcal Petroleum Corp.,0,0,3,0,0,3
Nori Corporation,0,0,3,0,0,3
Norris Stamping & Man. Co.,0,0,3,0,0,3
North Basin Energy Co.,0,0,3,0,0,3
Northern Oil Company,0,0,3,0,0,3
Northridge Oil Co.,0,0,3,0,0,3
Norwood Oil Co.,0,0,3,0,0,3
"Nugget Gas & Oil Co., Inc.",0,0,3,0,0,3
O. E. Owens,0,0,3,0,0,3
O. F. Darling,0,0,3,0,0,3
O. M. Slosson,0,0,3,0,0,3
Oil California Exploration,0,0,3,0,0,3
"Oil Producers, Inc.",0,0,3,0,0,3
Oil Well Management Co.,0,0,3,0,0,3
Oleo Fluo Co.,0,0,3,0,0,3
Olga-Ventura Oil Co.,0,0,3,0,0,3
Olympic Corp.,0,0,3,0,0,3
OrangeCo Dev. Co.,0,0,3,0,0,3
Orlando Oil Company,0,0,3,0,0,3
Otis Hoyt,0,0,3,0,0,3
"Overland Petroleum Co., Inc.",0,0,3,0,0,3
P. A. Kinard,0,0,3,0,0,3
P. M. Girard,0,0,3,0,0,3
Pacific Central Co.,0,0,3,0,0,3
Pacific Dry Ice Co.,0,0,3,0,0,3
Pacific Petro. Corp.,0,0,3,0,0,3
Par-Mer Oil Co.,0,0,3,0,0,3
Parbe Oil Corporation,0,0,3,0,0,3
Park Oil Co.,0,0,3,0,0,3
Pasadena Oil Co.,0,0,3,0,0,3
Paul G. Benedum,0,0,3,0,0,3
Paulin Oil Co.,0,0,3,0,0,3
Peak Oil Tool Service Inc.,0,0,3,0,0,3
Pearson-Sibert Oil Co. of Texas,0,0,3,0,0,3
Peter Palm,0,0,3,0,0,3
Petro Nova,0,0,3,0,0,3
Petroleum Associates,0,0,3,0,0,3
Petroleum Development Co.,0,0,3,0,0,3
Petroleum Expl. Co.,0,0,3,0,0,3
Petroleum Midway Co. Ltd.,0,0,3,0,0,3
Petrolum Securites Co.,0,0,3,0,0,3
Petromomnt Oil Corporation,0,0,3,0,0,3
Phelps Dodge Fuel Dev.,0,0,3,0,0,3
Philadelphia-California Pet,0,0,3,0,0,3
Philadelphia Oil Co.,0,0,3,0,0,3
Phillip L. Pike,0,0,3,0,0,3
Pioneer Drilling Co.,0,0,3,0,0,3
Placerita Oil Co.,0,0,3,0,0,3
Plateau Oil & Gas Co.,0,0,3,0,0,3
Ports of Call Oil Co.,0,0,3,0,0,3
Powers & Powers,0,0,3,0,0,3
Public Petroleum Company,0,0,3,0,0,3
"PWC Family Housing, L.P.",0,0,3,0,0,3
Quintana Production Co.,0,0,3,0,0,3
R & D Oil Company,0,0,3,0,0,3
R & R Development Co.,0,0,3,0,0,3
R. R. Mills,0,0,3,0,0,3
R. S. Bolling,0,0,3,0,0,3
R. T. Dennis,0,0,3,0,0,3
R. W. Sherman,0,0,3,0,0,3
Raak-Wilson Properties,0,0,3,0,0,3
Ralph Bennett,0,0,3,0,0,3
Ray Luse,0,0,3,0,0,3
Red Rock Oil Co.,0,0,3,0,0,3
Red Star Oil Co.,0,0,3,0,0,3
Regent Oil Co.,0,0,3,0,0,3
Reliance Oil Co.,0,0,3,0,0,3
"Rexford Industrial-9615 Norwalk, LLC",0,0,3,0,0,3
Rheem California Land Co.,0,0,3,0,0,3
Rhoads Oil Company,0,0,3,0,0,3
Richard M. Ferguson,0,0,3,0,0,3
Ring Petroleum corp.,0,0,3,0,0,3
Robert Barry,0,0,3,0,0,3
Robert Bowles Oil Co.,0,0,3,0,0,3
Rocky Mountain Drilling Company,0,0,3,0,0,3
Ross O. Nelson,0,0,3,0,0,3
Round Mountain Oil Company,0,0,3,0,0,3
Roy J. Berryhill and Deane Newenham,0,0,3,0,0,3
Rusty Walters Drilling Co.,0,0,3,0,0,3
S & M Oil Co.,0,0,3,0,0,3
S. M. S. Oil Co.,0,0,3,0,0,3
S. V. Smith,0,0,3,0,0,3
Sacramento Oil & Gas Co.,0,0,3,0,0,3
"Second Wind Production Company, Inc.",0,0,3,0,0,3
Security Pacific National Bank,0,0,3,0,0,3
Shigeki Hiratshuka,0,0,3,0,0,3
Sierra Energy Company,0,0,3,0,0,3
Sierra Reserve Company,0,0,3,0,0,3
Simian Oil Co.,0,0,3,0,0,3
"SLF-HB Magnolia, LLC",0,0,3,0,0,3
Smith & Vickers,0,0,3,0,0,3
Son Petroleum,0,0,3,0,0,3
Sound Petro. Inc.,0,0,3,0,0,3
"Spectra Exploration, Inc.",0,0,3,0,0,3
St. Anthony Oil Co.,0,0,3,0,0,3
St. Anthony Oil Corp.,0,0,3,0,0,3
St. James Oil Corporation,0,0,3,0,0,3
Stansbury-Webb,0,0,3,0,0,3
Stephen W. Bradford,0,0,3,0,0,3
"Stone Exploration, Inc.",0,0,3,0,0,3
Sun Coast Properties Inc.,0,0,3,0,0,3
Surety Oil Co.,0,0,3,0,0,3
T. A. Piper,0,0,3,0,0,3
T. L. Park,0,0,3,0,0,3
"T. T. Ellsworth, Operator",0,0,3,0,0,3
Tache Petroleum Co.,0,0,3,0,0,3
Taft Well Drlg. Co.,0,0,3,0,0,3
Taniye Dobashi (Mrs.),0,0,3,0,0,3
TEJ Ventures,0,0,3,0,0,3
Tenby Inc.,0,0,3,0,0,3
"Terra Bella Drilling Co., Ltd.",0,0,3,0,0,3
Terry Drilling Co.,0,0,3,0,0,3
Texcal Oil & Refining Co.,0,0,3,0,0,3
The Anschutz Corporation,0,0,3,0,0,3
The Emerald Oil Co.,0,0,3,0,0,3
"The Guidon Company, Inc.",0,0,3,0,0,3
The Procter and Gamble Co.,0,0,3,0,0,3
The Tejon Hills Company,0,0,3,0,0,3
The Twin State Oil Co.,0,0,3,0,0,3
Tony Landino,0,0,3,0,0,3
Totem Oil Co.,0,0,3,0,0,3
Traders Oil Corp.,0,0,3,0,0,3
Tres Sierras,0,0,3,0,0,3
Tri-Color Oil Co.,0,0,3,0,0,3
Tri Oil & Gas Co.,0,0,3,0,0,3
U-Tex Oil Co.,0,0,3,0,0,3
U S Great Pacific Resources Corp.,0,0,3,0,0,3
United Montebello Oil Co.,0,0,3,0,0,3
Unocal,0,0,3,0,0,3
Valley Energy Expl.,0,0,3,0,0,3
Venada Res.,0,0,3,0,0,3
Volvo Petro. Inc.,0,0,3,0,0,3
W. A. Sage,0,0,3,0,0,3
W. E. Medearis,0,0,3,0,0,3
W. E. Nicolai,0,0,3,0,0,3
W. F. Moore & Son Inc.,0,0,3,0,0,3
W. H. Taylor,0,0,3,0,0,3
"W. J.  Hamilton, Operator",0,0,3,0,0,3
"W. J. Johnson, Ren Elvis, Thar",0,0,3,0,0,3
W. R. Gerard,0,0,3,0,0,3
W. T. Woodward,0,0,3,0,0,3
W. W. Stabler,0,0,3,0,0,3
Wainoco Oil & Gas Company,0,0,3,0,0,3
Walter W. Eich,0,0,3,0,0,3
Watt Communities at Hadley Trails LLC,0,0,3,0,0,3
Wayne Ballinger,0,0,3,0,0,3
Weaver & Mola,0,0,3,0,0,3
West America Resources,0,0,3,0,0,3
Western Springs Petro. Co.,0,0,3,0,0,3
Westside Farming Co. Inc.,0,0,3,0,0,3
White River Exploration Co.,0,0,3,0,0,3
Wilkern Oil Co.,0,0,3,0,0,3
Willett Flying Service Inc.,0,0,3,0,0,3
William E Snee & Orville Eberly,0,0,3,0,0,3
William H. Noble,0,0,3,0,0,3
Williard W. Dinwiddie,0,0,3,0,0,3
Wilshire Oil Producers Co.,0,0,3,0,0,3
Wizard Oil Inc.,0,0,3,0,0,3
Wm. H. Brayton Trust,0,0,3,0,0,3
Wm. I. Zidell,0,0,3,0,0,3
"Wood-Callahan Oil Co., Ltd.",0,0,3,0,0,3
Zachary T. Tatum,0,0,3,0,0,3
Zuni Oil Co.,0,0,3,0,0,3
California Hydrocarbons Corporation,2,0,0,0,0,2
"CFT Oil & Gas, LLC",2,0,0,0,0,2
J and J Operators LLC,2,0,0,0,0,2
Leonard 1&2 LLC,2,0,0,0,0,2
"Pier Oil Company, Inc.",2,0,0,0,0,2
Rose Katherine Stone,2,0,0,0,0,2
Western Metals Corporation,2,0,0,0,0,2
Hiwa Petroleum Corp.,1,1,0,0,0,2
Jean Martinez,1,0,1,0,0,2
McDonald Ranch Partnership,1,0,1,0,0,2
William H. Fisk,1,0,1,0,0,2
A. R. Norris,0,2,0,0,0,2
Adams Drilling & Oil Co.,0,2,0,0,0,2
"Albert L. Cheney, Trustee",0,2,0,0,0,2
American Oilfield Co.,0,2,0,0,0,2
Antelope Oil & Gas Co.,0,2,0,0,0,2
Are-Bee Oil Syndicate,0,2,0,0,0,2
Arl Oil Co.,0,2,0,0,0,2
Avenal Land & Oil Co.,0,2,0,0,0,2
Barnett Rosenburg,0,2,0,0,0,2
Bayers & Roberts,0,2,0,0,0,2
Big Five Oil Co.,0,2,0,0,0,2
Bill Nye Oil Co.,0,2,0,0,0,2
C. B. Lones,0,2,0,0,0,2
C. R. Schuster,0,2,0,0,0,2
California Northern Petro. Co.,0,2,0,0,0,2
Califranco Oil Co.,0,2,0,0,0,2
Chicago Ferndale Oil Co.,0,2,0,0,0,2
Clearwater Petro. Co.,0,2,0,0,0,2
"Crockett Drilling Synd., Inc.",0,2,0,0,0,2
Dogget & Fletcher,0,2,0,0,0,2
Doran & Brouse,0,2,0,0,0,2
Doris V. Yu Revocable Trust,0,2,0,0,0,2
"EcoTech EOR, LLC",0,2,0,0,0,2
F. E. Bundy,0,2,0,0,0,2
Fairview Oil Co.,0,2,0,0,0,2
Fletcher Oil & Refining Co.,0,2,0,0,0,2
Frank Davis,0,2,0,0,0,2
G. W. Albright,0,2,0,0,0,2
Geo. Geigrich,0,2,0,0,0,2
Geo. Lawrence,0,2,0,0,0,2
George Ford,0,2,0,0,0,2
H. B. Carter,0,2,0,0,0,2
H. H. Harrison,0,2,0,0,0,2
Hardly Able Oil Co. (Pre 1977),0,2,0,0,0,2
Helen Sanborn,0,2,0,0,0,2
Henry Harper,0,2,0,0,0,2
Herman Fisher,0,2,0,0,0,2
J. Trafton,0,2,0,0,0,2
Johnson Newman,0,2,0,0,0,2
Joseph Hummel,0,2,0,0,0,2
K & J Oil Co. Inc.,0,2,0,0,0,2
Kings Co.,0,2,0,0,0,2
L. B. Chase Oil Co.,0,2,0,0,0,2
L. F. Bassett and Blaine White,0,2,0,0,0,2
L. W. Rippeto,0,2,0,0,0,2
Lamona Oil Association,0,2,0,0,0,2
Leasure Family Trust,0,2,0,0,0,2
Liberty Petroleum Co.,0,2,0,0,0,2
Little Oil Co.,0,2,0,0,0,2
Lompoc Petroleum Co.,0,2,0,0,0,2
Lora J. Oil Co.,0,2,0,0,0,2
Lost Hills Syndicate,0,2,0,0,0,2
Lyceum Oil Syndicate,0,2,0,0,0,2
Maier & Zoblein Brewing Co.,0,2,0,0,0,2
Mark L. Hawley,0,2,0,0,0,2
Mericos Oil Co.,0,2,0,0,0,2
Montebello Oil syndicate,0,2,0,0,0,2
Mrs. Manett,0,2,0,0,0,2
N. Conkhite,0,2,0,0,0,2
Nettleton & Kellerman,0,2,0,0,0,2
North Whittier Oil Co.,0,2,0,0,0,2
Off Broadway Mineral Rights,0,2,0,0,0,2
Oil King Oil Co.,0,2,0,0,0,2
"Orchard E&P, LLC",0,2,0,0,0,2
Panoche Vallecitos Oil Co.,0,2,0,0,0,2
Phoenix Oil Co.,0,2,0,0,0,2
Rieder-Haag Company,0,2,0,0,0,2
Spadra Oil Co.,0,2,0,0,0,2
Tanksley & Southard,0,2,0,0,0,2
"Underground Energy, Inc.",0,2,0,0,0,2
Union Jack Oil Co.,0,2,0,0,0,2
W. Dryden,0,2,0,0,0,2
W. S. Collins,0,2,0,0,0,2
Whittier Ext Mutual Water Co.,0,2,0,0,0,2
Yankee Girl Oil Co.,0,2,0,0,0,2
A. J. Singer,0,1,1,0,0,2
A. P. Wallace,0,1,1,0,0,2
A. W. Duncan,0,1,1,0,0,2
Amazon Drilling Corp.,0,1,1,0,0,2
America Oil Co.,0,1,1,0,0,2
Andrew M. Anderson,0,1,1,0,0,2
Arcadia Oil Co.,0,1,1,0,0,2
Arctic Oil Co.,0,1,1,0,0,2
Arizona Oil Co.,0,1,1,0,0,2
B & G Development Co.,0,1,1,0,0,2
B. A. Laselle & J.L. Van Disse,0,1,1,0,0,2
B. D. Owens,0,1,1,0,0,2
Biltmore Petro. Corp.,0,1,1,0,0,2
Birch & Royer,0,1,1,0,0,2
Black Pearl Oil Co.,0,1,1,0,0,2
Bonded Oil Syndicate,0,1,1,0,0,2
Burton Benwell,0,1,1,0,0,2
C & F Oil Co.,0,1,1,0,0,2
C. S. Akers,0,1,1,0,0,2
California Frost Preventative Co.,0,1,1,0,0,2
California Pacific Oil Co.,0,1,1,0,0,2
Carson Oil Corp.,0,1,1,0,0,2
Chas. W. Fourl,0,1,1,0,0,2
Coast Line Oil Co.,0,1,1,0,0,2
Commercial Oil Co.,0,1,1,0,0,2
Conejo Syndicate,0,1,1,0,0,2
Cosmopolitan Oil Co.,0,1,1,0,0,2
Courtney Petro. Co.,0,1,1,0,0,2
D. S. White,0,1,1,0,0,2
Del Rosa Oil & Gas Co.,0,1,1,0,0,2
"Delhi Oil Association, Ltd.",0,1,1,0,0,2
Dollar Oil Corp. Ltd.,0,1,1,0,0,2
E G Lewis,0,1,1,0,0,2
E. & G. Products Co.,0,1,1,0,0,2
E. A. Lamb,0,1,1,0,0,2
E. R. Carey,0,1,1,0,0,2
E. T. Edwards,0,1,1,0,0,2
Eastern Interion Oil Co.,0,1,1,0,0,2
Elbe Oil Land Dev. Co.,0,1,1,0,0,2
Elk Hills Pool Oil Co.,0,1,1,0,0,2
Equitable Oil Syndicate No. 1,0,1,1,0,0,2
Esperanza Land & Oil Co.,0,1,1,0,0,2
Fearless Oil Co.,0,1,1,0,0,2
Fred A. Walker,0,1,1,0,0,2
Frontier Oil Co.,0,1,1,0,0,2
Gasch & Associates,0,1,1,0,0,2
George A. Denison,0,1,1,0,0,2
George Blair,0,1,1,0,0,2
Golden Dome Oil Co. Inc.,0,1,1,0,0,2
Golden West Crude Oil Co.,0,1,1,0,0,2
"Green Earth Resources, Inc.",0,1,1,0,0,2
Green Mt. Oil Co.,0,1,1,0,0,2
Harris Oil Co.,0,1,1,0,0,2
Harry Crinklaw,0,1,1,0,0,2
HB12 Partners LLC,0,1,1,0,0,2
Hesperia Oil & Gas Co. of Calif.,0,1,1,0,0,2
Huntington Downey Oil Co.,0,1,1,0,0,2
Hutchinson Bros. & Teel,0,1,1,0,0,2
Industrial Oil Syndicate #4,0,1,1,0,0,2
J. E. & R. H. McCreary,0,1,1,0,0,2
J. G. Tavares,0,1,1,0,0,2
Joseph K. Tobin,0,1,1,0,0,2
Kirkpatrick Syndicate 2,0,1,1,0,0,2
La Merced Drilling Co.,0,1,1,0,0,2
Laddie Boy Nos. 1 & 2,0,1,1,0,0,2
Lena Pauline Savage,0,1,1,0,0,2
Los Gatos Oil Co.,0,1,1,0,0,2
M. W. Mcvey,0,1,1,0,0,2
"Medley Oil & Gas, LLC",0,1,1,0,0,2
Montebello Mascot Oil Co.,0,1,1,0,0,2
Morris Harris,0,1,1,0,0,2
Mountainhouse Oil Co.,0,1,1,0,0,2
National Gas Syndicate,0,1,1,0,0,2
National Security Oil Co.,0,1,1,0,0,2
Nevada Signal Hill Oil Co.,0,1,1,0,0,2
Nevada Ventura Oil Synd.,0,1,1,0,0,2
North Valley Gaswell Services,0,1,1,0,0,2
"Northstar Resources, Inc.",0,1,1,0,0,2
O. R. Howard & Co.,0,1,1,0,0,2
Oro Negro Oil Co.,0,1,1,0,0,2
Pioneer Development Company,0,1,1,0,0,2
R. E. Ibbetson Drilling Co.,0,1,1,0,0,2
Reliance Home Investment Co.,0,1,1,0,0,2
Rucker and Croul,0,1,1,0,0,2
San Bernardino & Colton Oil Co.,0,1,1,0,0,2
Santa Fe Springs Oil synd. No. 2,0,1,1,0,0,2
Santiago Oil Co.,0,1,1,0,0,2
Shallow Field Oil Co.,0,1,1,0,0,2
Shamrock Drilling Co.,0,1,1,0,0,2
Silverado Oil Co.,0,1,1,0,0,2
South Fullerton Oil Co.,0,1,1,0,0,2
Southeastern Limited Oil Co.,0,1,1,0,0,2
Southern California Oil Co.,0,1,1,0,0,2
Stewart Anderson Syndicates,0,1,1,0,0,2
Sugar Loaf Oil Assoc.,0,1,1,0,0,2
T & M Exploration Company,0,1,1,0,0,2
Temblor Oil Co.,0,1,1,0,0,2
The MacGregor Corp.,0,1,1,0,0,2
Three for One Oil Royalties,0,1,1,0,0,2
Title Insurance & Trust Co.,0,1,1,0,0,2
Tri-Field Producers Syndicate,0,1,1,0,0,2
Tucker & Johnston Lease,0,1,1,0,0,2
"Tureco Oil Co., Ltd.",0,1,1,0,0,2
Ventura Consolidated Oil Co.,0,1,1,0,0,2
Ventura Oil syndicate #1,0,1,1,0,0,2
Veta Grande Development Co.,0,1,1,0,0,2
White Eagle Petroleum Co.,0,1,1,0,0,2
Whittier Grande Oil Co.,0,1,1,0,0,2
Wm E. Garner,0,1,1,0,0,2
10622 Court Ave LLC,0,0,2,0,0,2
3-J Oil Operators,0,0,2,0,0,2
"3279 Bernard L.P., A California Limited Partnership",0,0,2,0,0,2
6200 GR LLC,0,0,2,0,0,2
"888-6 Partners, LLC",0,0,2,0,0,2
A-1 Oil Well Service Co.,0,0,2,0,0,2
A. D. Mitchell & Son,0,0,2,0,0,2
"A. G. Linkletter, Operator",0,0,2,0,0,2
A. J. Louden,0,0,2,0,0,2
"A. J. Petersen, Oil Oper.",0,0,2,0,0,2
A. J. Ross,0,0,2,0,0,2
A. M. Nahabedian Opr.,0,0,2,0,0,2
A. O. Lewis,0,0,2,0,0,2
Acme Petroleum Co.,0,0,2,0,0,2
Admiral Oil Company,0,0,2,0,0,2
Aetna Oil Co.,0,0,2,0,0,2
"AEW/O'Donnell, LLC",0,0,2,0,0,2
Agoil Co.,0,0,2,0,0,2
Airways Petro. Corp.,0,0,2,0,0,2
Alamitos Oil Co.,0,0,2,0,0,2
Alford Drilling and Exp. Co.,0,0,2,0,0,2
Alfred T Lockwood et al,0,0,2,0,0,2
Alligator Oil Co.,0,0,2,0,0,2
Allison & Prestridge,0,0,2,0,0,2
Almar Oil Co.,0,0,2,0,0,2
Aloha Oil Co.,0,0,2,0,0,2
Alphonzo E. Bell Corporation,0,0,2,0,0,2
Alpoil Co.,0,0,2,0,0,2
Altadena Oil Co.,0,0,2,0,0,2
Alvin O. Preszler,0,0,2,0,0,2
Amador Expl. Co.,0,0,2,0,0,2
Amalgamated Oil & Gas Corp.,0,0,2,0,0,2
Ambassador Oil Corp.,0,0,2,0,0,2
American Copper Company,0,0,2,0,0,2
American Placers Inc,0,0,2,0,0,2
American Reserve Oil Company,0,0,2,0,0,2
"Aminoil USA, Inc. & Dwight G. Vedder",0,0,2,0,0,2
Amy B. Rust,0,0,2,0,0,2
Andrew Lin,0,0,2,0,0,2
Andrews & Lancaster,0,0,2,0,0,2
Anglo-Calif Oil Synd,0,0,2,0,0,2
Anthonian Drilling Co.,0,0,2,0,0,2
Anthony Oberholtz,0,0,2,0,0,2
APC Operating Partnership,0,0,2,0,0,2
Applegate & Herwick,0,0,2,0,0,2
Aquarian Petro. Corp.,0,0,2,0,0,2
Archie C. Myers,0,0,2,0,0,2
Armor Petroleum Ltd.,0,0,2,0,0,2
Arthur Studley,0,0,2,0,0,2
Asioco Inc.,0,0,2,0,0,2
Associated Dev. Co.,0,0,2,0,0,2
Associated Piping & Engineering Co.,0,0,2,0,0,2
Atascadero Oil Co.,0,0,2,0,0,2
Atlantic & Western Oil Co.,0,0,2,0,0,2
Atlantic Oil Co.-Miller & Ford,0,0,2,0,0,2
Azores Oil Co.,0,0,2,0,0,2
B & T Drilling,0,0,2,0,0,2
B. B. Beckenridge,0,0,2,0,0,2
B. C. Barnes,0,0,2,0,0,2
B. C. Morrison,0,0,2,0,0,2
B. F. DeLanty,0,0,2,0,0,2
B. J. Marks Family,0,0,2,0,0,2
B. Milo Mitchel,0,0,2,0,0,2
"B. W. Freudenthal, James T. Dowling and John T. Holt",0,0,2,0,0,2
Baker-Grover Oil,0,0,2,0,0,2
Bakersfield Oil Company,0,0,2,0,0,2
Bard Oil & Asphalt Co.,0,0,2,0,0,2
Bardeen Petro. Co. Ltd.,0,0,2,0,0,2
Bardsdale Canon,0,0,2,0,0,2
Bartholomae Oil Corporation,0,0,2,0,0,2
Bass & Goodknight,0,0,2,0,0,2
Bastanchury Oil Co.,0,0,2,0,0,2
"Battaglia, Wolfson and Barnes",0,0,2,0,0,2
Bee Oil Co.,0,0,2,0,0,2
Belco Petro. Corp.,0,0,2,0,0,2
Belinda Petro & Intex Oil,0,0,2,0,0,2
"Bell & Burden, Inc.",0,0,2,0,0,2
Belmont Oil Co.,0,0,2,0,0,2
Belridge Oil Co.,0,0,2,0,0,2
Ben and Reuben Mooschekian,0,0,2,0,0,2
Ben D. Owens,0,0,2,0,0,2
Benito-Huntington Oil Co.,0,0,2,0,0,2
Benjamin D. Leverett,0,0,2,0,0,2
"Benjamin D. Leverett, Operator",0,0,2,0,0,2
Benjamin F. Bailard,0,0,2,0,0,2
Berenergy Corporation,0,0,2,0,0,2
"Berg, Laney & Brown",0,0,2,0,0,2
Bergman Oil Company,0,0,2,0,0,2
Bessie Berman,0,0,2,0,0,2
Betsy Corp.,0,0,2,0,0,2
Beulah Oil Co.,0,0,2,0,0,2
Beverly-Montebello Oil Co.,0,0,2,0,0,2
BHTH,0,0,2,0,0,2
Big Eight Oil Company,0,0,2,0,0,2
Birch-Royer Oil Company,0,0,2,0,0,2
Birch Ranch & Oil & I.S.Burgess,0,0,2,0,0,2
Bitterwater Dev. Co.,0,0,2,0,0,2
Blair Oil Co.,0,0,2,0,0,2
Blake and Frampton,0,0,2,0,0,2
"Blosser Fee Owner, LLC",0,0,2,0,0,2
Blue Ridge Oil Co.,0,0,2,0,0,2
Bluebell Oil Co.,0,0,2,0,0,2
Bob Crupper,0,0,2,0,0,2
Boe Tunstall Co.,0,0,2,0,0,2
"Bolthouse Properties, LLC",0,0,2,0,0,2
Boswell Perforating Co.,0,0,2,0,0,2
Bradley Oil Co.,0,0,2,0,0,2
Bravo Oil Co.,0,0,2,0,0,2
Brea-Olinda Oil Co.,0,0,2,0,0,2
Brown-Saffold Drilling Co.,0,0,2,0,0,2
"Browning-Ferris Industries of California, Inc.",0,0,2,0,0,2
Buaas Dev. Co.,0,0,2,0,0,2
Burl G. Varner,0,0,2,0,0,2
Burnett Co.,0,0,2,0,0,2
Bushnell Oil Corp.,0,0,2,0,0,2
Buttes Resources Company,0,0,2,0,0,2
Buttram Oil Co.,0,0,2,0,0,2
"C&C Mountaingate, Inc.",0,0,2,0,0,2
C. A. Luckey,0,0,2,0,0,2
C. A. Maino,0,0,2,0,0,2
C. C. Herwick,0,0,2,0,0,2
C. C. Julian and Co.,0,0,2,0,0,2
C. G. Willis,0,0,2,0,0,2
C. H. Whittier,0,0,2,0,0,2
C. Harris-D Horne & P Neig,0,0,2,0,0,2
C. M. S. Oil and Drilling Co.,0,0,2,0,0,2
C. S. Blinn & J.W. Aidlin,0,0,2,0,0,2
C. T. Dougherty,0,0,2,0,0,2
C.K.M. Oil Co.,0,0,2,0,0,2
Cabot Petro. Corp.,0,0,2,0,0,2
Cajon Oil Co.,0,0,2,0,0,2
"Cajon Oil Co., Ltd.",0,0,2,0,0,2
Cal-American Pet. Corp.,0,0,2,0,0,2
Cal-Oak Oil Co.,0,0,2,0,0,2
"Cal Farm Invest, Inc.",0,0,2,0,0,2
Cal Oil and Gas Company,0,0,2,0,0,2
Calif Exploration Co.,0,0,2,0,0,2
Calif Petro Prod Co.,0,0,2,0,0,2
Calif.-Wyoming Oil Producers,0,0,2,0,0,2
California-Time Petroleum Company,0,0,2,0,0,2
California Marine Oil & Refining Co.,0,0,2,0,0,2
California Prod. Co.,0,0,2,0,0,2
"California/Nevada Developments, LLC",0,0,2,0,0,2
Calitex Land & Dev. Co.,0,0,2,0,0,2
Calpetro Producers Synd.,0,0,2,0,0,2
Calplans Resources,0,0,2,0,0,2
Calray Petro. Corp.,0,0,2,0,0,2
Calumet Gold Mines Co.,0,0,2,0,0,2
Caminol Co.,0,0,2,0,0,2
Campbell and Shell Incorporated,0,0,2,0,0,2
Camrich Drilling Co.,0,0,2,0,0,2
Canadian Queen Oil Co.,0,0,2,0,0,2
"Cape Mendocino Oil Co., Inc.",0,0,2,0,0,2
Capital Production Company,0,0,2,0,0,2
Carissa Oil Company,0,0,2,0,0,2
Carl Long,0,0,2,0,0,2
Carl M. Weaver,0,0,2,0,0,2
Carpinteria Oil Co.,0,0,2,0,0,2
Carson Dominguez Real Est Corp,0,0,2,0,0,2
Casitas Oil Co.,0,0,2,0,0,2
Casmalia Ranch Oil & Dev.,0,0,2,0,0,2
Castaic Highlands Oil Co.,0,0,2,0,0,2
Cather & McCallen Wells,0,0,2,0,0,2
CD Cunningham & HP MaCauley,0,0,2,0,0,2
Cecil Basenberg,0,0,2,0,0,2
"Cedric E. Brown Gas & Oil Co., Ltd.",0,0,2,0,0,2
Central Calif. Expl. Co.,0,0,2,0,0,2
Centralia Oil Company,0,0,2,0,0,2
Century Production Inc.,0,0,2,0,0,2
Century Service Inc.,0,0,2,0,0,2
"Cerutti & Thompson Trans. Co., Oper.",0,0,2,0,0,2
"Chadmar/Colfin Rolling Hills, LLC",0,0,2,0,0,2
Chalmers-Santa Fe LLC,0,0,2,0,0,2
Channel Oil & Devl Co. Ltd,0,0,2,0,0,2
Charles F. Holmes,0,0,2,0,0,2
Charles Howard,0,0,2,0,0,2
Charles L Ross,0,0,2,0,0,2
Charles R North,0,0,2,0,0,2
Chas Taylor Johnson,0,0,2,0,0,2
Chas. R. Jacobson,0,0,2,0,0,2
Chaz Oil Corp.,0,0,2,0,0,2
"Chevron USA, Inc.",0,0,2,0,0,2
Cholame Oil Co.,0,0,2,0,0,2
Circle Oil Co.,0,0,2,0,0,2
Cities Service Company,0,0,2,0,0,2
City and County of San Francisco,0,0,2,0,0,2
"City Ventures Homebuilding, LLC",0,0,2,0,0,2
Cleary Petroleum Corporation,0,0,2,0,0,2
Cleveland Oil Company,0,0,2,0,0,2
Coalinga Royal Oil Co.,0,0,2,0,0,2
Coalinga Sulfur Baths & Plunge,0,0,2,0,0,2
Coawaca Petrol Corp.,0,0,2,0,0,2
"Coloma Oil Co., Ltd.",0,0,2,0,0,2
Colony Oil Co.,0,0,2,0,0,2
Colorado Oil & Gas Corp.,0,0,2,0,0,2
Columbia Oil Co.,0,0,2,0,0,2
Columbian Oil Asphalt & Refinery,0,0,2,0,0,2
Colusa Expl. Co.,0,0,2,0,0,2
Combine Oil Co.,0,0,2,0,0,2
Commercial - Petro Gas Inc.,0,0,2,0,0,2
"Commonwealth Consol. Gas, Ltd.",0,0,2,0,0,2
Compton Oil Co.,0,0,2,0,0,2
"Comstock Housing, Inc.",0,0,2,0,0,2
Conejo Oil Syndicate,0,0,2,0,0,2
"Continental U.S. Exploration, Inc.",0,0,2,0,0,2
Convoy Petro. Co.,0,0,2,0,0,2
Cooper Petro. Co.,0,0,2,0,0,2
"Cordova Oil Co., Ltd.",0,0,2,0,0,2
Corona Development Co. Inc.,0,0,2,0,0,2
"Corona Holding, LLC",0,0,2,0,0,2
"Corrigan Petro. Corp., Ltd.",0,0,2,0,0,2
Cox & Ferguson,0,0,2,0,0,2
Crawford and Hiles,0,0,2,0,0,2
Crawford Henly,0,0,2,0,0,2
Creme Petro.,0,0,2,0,0,2
Crestmont Oil & Gas Co.,0,0,2,0,0,2
Crimson Resource Mgmt.,0,0,2,0,0,2
Crown Drilling Co.,0,0,2,0,0,2
Crude Oil Co.,0,0,2,0,0,2
Cuyama Oil Co.,0,0,2,0,0,2
Cymric Oil Co.,0,0,2,0,0,2
D & S Oil Co.,0,0,2,0,0,2
D. M. Hollingsworth,0,0,2,0,0,2
D. S. Fletcher,0,0,2,0,0,2
D. W. Elliott,0,0,2,0,0,2
"D. W. Elliott, Inc.",0,0,2,0,0,2
"Dahlquist Drilling, Inc.",0,0,2,0,0,2
Daniel Fisher,0,0,2,0,0,2
"Daniel W. Elliott, Jr. Operator",0,0,2,0,0,2
Danish Oil & Devl Co.,0,0,2,0,0,2
David Jacoby,0,0,2,0,0,2
"David R. Faries, Trustee",0,0,2,0,0,2
"Davis, Edward G.",0,0,2,0,0,2
Dawson Devl Co.,0,0,2,0,0,2
Day Oil Co.,0,0,2,0,0,2
Delta Petro. Co.,0,0,2,0,0,2
Delta Petroleum Corporation,0,0,2,0,0,2
Department of Conservation,0,0,2,0,0,2
Derby Farms,0,0,2,0,0,2
Desco Oil Company,0,0,2,0,0,2
Devil's Den Products Co.,0,0,2,0,0,2
Devils Den Oil Company,0,0,2,0,0,2
"Dil-Harp Oil, Ltd.",0,0,2,0,0,2
Dixie Dome Oil Co.,0,0,2,0,0,2
DLM Ventures,0,0,2,0,0,2
Don H. Skone,0,0,2,0,0,2
Dos Lobos Oil Co.,0,0,2,0,0,2
Dow Chemical Co.,0,0,2,0,0,2
Dr. George G. Averill,0,0,2,0,0,2
Drilling & Expl Co. Inc.,0,0,2,0,0,2
"DRL, Inc.",0,0,2,0,0,2
Dudley Dome Oil & Gas Co.,0,0,2,0,0,2
"Dumm Bros., Olympic Ref.",0,0,2,0,0,2
Duncan MacLeod,0,0,2,0,0,2
E-Z Serve of CA Inc.,0,0,2,0,0,2
E. B. & M.,0,0,2,0,0,2
E. B. Guess,0,0,2,0,0,2
E. E. Fogelson,0,0,2,0,0,2
E. G. Starr,0,0,2,0,0,2
E. H. Christian Drilling Co.,0,0,2,0,0,2
E. H. Moore Inc.,0,0,2,0,0,2
E. J. Harp,0,0,2,0,0,2
E. J. Miller,0,0,2,0,0,2
E. L. Blanton,0,0,2,0,0,2
E. M. Easton,0,0,2,0,0,2
E. P. Jennings,0,0,2,0,0,2
E. T. Wix,0,0,2,0,0,2
E. V. Edmondson,0,0,2,0,0,2
"Eagle Oil & Gas Co., Ltd.",0,0,2,0,0,2
Eagle Oil & Refining Co. Inc.,0,0,2,0,0,2
Eagle Petro. Consultants,0,0,2,0,0,2
East Edison Oil Co.,0,0,2,0,0,2
East Montebello Oil Co.,0,0,2,0,0,2
Eastern American Energy Corp.,0,0,2,0,0,2
"Ebonoro Oil Company, Inc.",0,0,2,0,0,2
Edco Oil Co.,0,0,2,0,0,2
Edison Oil Co.,0,0,2,0,0,2
Edward Lustgarten and Ned Barmore,0,0,2,0,0,2
"Edward Mike Davis, L.L.C.",0,0,2,0,0,2
"Edward Tsutomu Nakama and Kiyoko Nakama, Trustee of the Nakama Family Trust dated May 20, 1986",0,0,2,0,0,2
"Edwin J. Champion, Hemphill & Schneider",0,0,2,0,0,2
Edwin W. & Harold R. Pauley,0,0,2,0,0,2
Edwin W. Pauley & D Frankel,0,0,2,0,0,2
Ekoh Oil Co.,0,0,2,0,0,2
El Chico Corp.,0,0,2,0,0,2
El Segundo Oil Co.,0,0,2,0,0,2
Elbee Petroleum Co.,0,0,2,0,0,2
"Elf Aquitaine, Inc.",0,0,2,0,0,2
Eljohn Petroleum Corporation,0,0,2,0,0,2
Elk Hills Central Oil Co.,0,0,2,0,0,2
Elk Hills Development Co.,0,0,2,0,0,2
Elko Drilling Company,0,0,2,0,0,2
Elliott Consolidated Oil Co.,0,0,2,0,0,2
Elmer A. Roth,0,0,2,0,0,2
Elmer B. Stone,0,0,2,0,0,2
Ember Oil and Gas Co.,0,0,2,0,0,2
"Emerald Trail, LLC",0,0,2,0,0,2
Emil L. Menveg,0,0,2,0,0,2
Emmett J. Culligan,0,0,2,0,0,2
Energy Development Corp.,0,0,2,0,0,2
Erie Oil Co.,0,0,2,0,0,2
Erin Oil Co.,0,0,2,0,0,2
Esendee Company,0,0,2,0,0,2
Estate of Frederick A. Speik,0,0,2,0,0,2
Estate of L. C. Dougan,0,0,2,0,0,2
Estate of L. H. Benningsdorf,0,0,2,0,0,2
Estate of Roy J. Berryhill,0,0,2,0,0,2
Estate of T. E. Hotz,0,0,2,0,0,2
Estate of V R Smith,0,0,2,0,0,2
Estes-Cross Co.,0,0,2,0,0,2
Ethyl Oil Co.,0,0,2,0,0,2
Euclid Petro. Co. Inc.,0,0,2,0,0,2
Eureka Crude,0,0,2,0,0,2
Evangelical Free Church,0,0,2,0,0,2
Ewan Oil Co.,0,0,2,0,0,2
Excel-Mineral Co.,0,0,2,0,0,2
Ezra Taylor,0,0,2,0,0,2
F. A. Miller,0,0,2,0,0,2
F. A. Winchester,0,0,2,0,0,2
F. C. Fabry & L C Bowles,0,0,2,0,0,2
F. H. Allen,0,0,2,0,0,2
F. R. Anderson Associates,0,0,2,0,0,2
F. W. Bishop,0,0,2,0,0,2
Fair Mesa Oil Co.,0,0,2,0,0,2
Fairfield-Volunteer Petro,0,0,2,0,0,2
Falcon Oil & Gas Co.,0,0,2,0,0,2
Farris Oil Co.,0,0,2,0,0,2
Federal Oil Co. of Cal.,0,0,2,0,0,2
Felton Oil Co.,0,0,2,0,0,2
Fickert Oil Co.,0,0,2,0,0,2
Finley Company,0,0,2,0,0,2
First Chinese Baptist Church,0,0,2,0,0,2
"Fletcher Oil Co., Inc.",0,0,2,0,0,2
Fornachon & Wilson Inc.,0,0,2,0,0,2
Forster Oil Co.,0,0,2,0,0,2
Four Star Oil Co.,0,0,2,0,0,2
Fowler Drilling & Prod. Co.,0,0,2,0,0,2
Fox M. Boswell and Assoc.,0,0,2,0,0,2
Fox Oil Co.,0,0,2,0,0,2
Frank Buttram,0,0,2,0,0,2
Frank Cannella and Thomas Cannella,0,0,2,0,0,2
Frank E. Abbott,0,0,2,0,0,2
Frank M. Taylor Assoc.,0,0,2,0,0,2
"Frankley, Andrews & Zellers",0,0,2,0,0,2
Fred Bever,0,0,2,0,0,2
Fred M. Manning,0,0,2,0,0,2
Fred M. Sayre,0,0,2,0,0,2
Freem Oil Co.,0,0,2,0,0,2
Fremont Oil Company,0,0,2,0,0,2
Fremont Oil Corp.,0,0,2,0,0,2
Freudenthal and Myers Expl. Co.,0,0,2,0,0,2
Frontier Petro.,0,0,2,0,0,2
Fulton Producing Company,0,0,2,0,0,2
G & E Oil Co.,0,0,2,0,0,2
G & F Oil Co.,0,0,2,0,0,2
G & H Oil Co.,0,0,2,0,0,2
G. J. Magenheimer,0,0,2,0,0,2
G. R. Nance,0,0,2,0,0,2
G. R. Nance & Associates,0,0,2,0,0,2
"G.E.O. Oil & Gas Co., Inc.",0,0,2,0,0,2
Gabriel Oil Co.,0,0,2,0,0,2
Gamma Corp.,0,0,2,0,0,2
Garner-GH Petroleum Co.,0,0,2,0,0,2
"Garner, Lyle A.",0,0,2,0,0,2
"Gas Properties, Inc.",0,0,2,0,0,2
Gaviota Oil Co. of Delaware,0,0,2,0,0,2
"Geo. F. Getty, Inc.",0,0,2,0,0,2
Geo. M. White,0,0,2,0,0,2
George Allen,0,0,2,0,0,2
George E. Willett,0,0,2,0,0,2
George G. Parry,0,0,2,0,0,2
George J Greer,0,0,2,0,0,2
George L. Clayton,0,0,2,0,0,2
George L. Dobson,0,0,2,0,0,2
George Morgan,0,0,2,0,0,2
George W. Stout,0,0,2,0,0,2
George Walters Ind Oil & Gas,0,0,2,0,0,2
Gibralter Res.,0,0,2,0,0,2
Gilliland Oil Co. & Estate of O. C. Davis,0,0,2,0,0,2
Glen H. Mitchel & The Mitchel Co.,0,0,2,0,0,2
Glen Ogles Oil Co.,0,0,2,0,0,2
"Golden Arrow Oil Co., Inc.",0,0,2,0,0,2
Golden Bear Oil Specialties,0,0,2,0,0,2
Golden V Oil Co. and F. E. Snowden,0,0,2,0,0,2
Golden West Association,0,0,2,0,0,2
Golden West Oil Corp.,0,0,2,0,0,2
Goldenwest Partners LLC,0,0,2,0,0,2
Goodknight & Proctor,0,0,2,0,0,2
Gordon Green Guiberson Trust,0,0,2,0,0,2
Gore Exploration Co.,0,0,2,0,0,2
Goshen Syndicate,0,0,2,0,0,2
Grable & Ervin,0,0,2,0,0,2
Graham Supply Co.,0,0,2,0,0,2
Grober and Assoc.,0,0,2,0,0,2
Group Syndicate,0,0,2,0,0,2
Gunnar Eriksson,0,0,2,0,0,2
"Guy H. Cherry, Jr.",0,0,2,0,0,2
H. B. Oil Company,0,0,2,0,0,2
H. C. Sommer,0,0,2,0,0,2
H. F. Gibson,0,0,2,0,0,2
H. F. Schlittler,0,0,2,0,0,2
H. Giessner,0,0,2,0,0,2
H. J. Barneson,0,0,2,0,0,2
H. J. Montgomery,0,0,2,0,0,2
H. M. Johnson,0,0,2,0,0,2
H. S. Kohlbush,0,0,2,0,0,2
H. W. Schafer,0,0,2,0,0,2
H.E.R. Petroleum Co.,0,0,2,0,0,2
Halvern L Norris,0,0,2,0,0,2
Hamarson Oil Co.,0,0,2,0,0,2
"Hamilton Dome Oil Co., Ltd.",0,0,2,0,0,2
Hamman Brothers,0,0,2,0,0,2
"Hangtown Oil, LLC",0,0,2,0,0,2
Harmony Dobyns Oil Syndicate,0,0,2,0,0,2
Harold E. Marconda,0,0,2,0,0,2
Harold S. Cook Jr. & Assoc,0,0,2,0,0,2
Harriman Jones Oil Co.,0,0,2,0,0,2
Harry Long,0,0,2,0,0,2
Harry P. Diamond,0,0,2,0,0,2
Hastings Harcourt,0,0,2,0,0,2
HCT Oil & Gas Co.,0,0,2,0,0,2
Healy & Weiss,0,0,2,0,0,2
Helen G. Milligan (Mrs.),0,0,2,0,0,2
Helm Co. -H R & Robt Sumpf,0,0,2,0,0,2
Helmer L. Johnson,0,0,2,0,0,2
Henderson Petro. Corp.,0,0,2,0,0,2
Henry R. Dabney,0,0,2,0,0,2
Herbert J. Solomon,0,0,2,0,0,2
Herley-Kelley,0,0,2,0,0,2
Herley-Kelley Oil Operations,0,0,2,0,0,2
Herley Supply Co.,0,0,2,0,0,2
Highland Oil Corp.,0,0,2,0,0,2
"Hil-Mar Drilling Co., Inc.",0,0,2,0,0,2
Hocking & Andrews,0,0,2,0,0,2
Hogan Petroleum Corp.,0,0,2,0,0,2
Holly Res. Corp.,0,0,2,0,0,2
Home Builders Realty Corp.,0,0,2,0,0,2
"Hooker Dome Syndicate, Ltd.",0,0,2,0,0,2
Hoover Drilling Co.,0,0,2,0,0,2
Hou-Tex Prod. Co.,0,0,2,0,0,2
Howard G. Morning,0,0,2,0,0,2
"Howard Oil Co., Inc.",0,0,2,0,0,2
Howells Brothers,0,0,2,0,0,2
Hoyet Greenwood,0,0,2,0,0,2
Hoyt S. Gale,0,0,2,0,0,2
"Hubert N. Witt & Assoc., Inc.",0,0,2,0,0,2
Hubl/Harbin,0,0,2,0,0,2
Hugh B. Martin,0,0,2,0,0,2
Hugh McPhaill,0,0,2,0,0,2
Humboldt Oil Co.,0,0,2,0,0,2
Humiston Investment Co.,0,0,2,0,0,2
Hunter-Scanlin,0,0,2,0,0,2
"Huntington Beach Pacific Coast Enterprises, LLC",0,0,2,0,0,2
"Huntington Energy, L.L.C.",0,0,2,0,0,2
Huntington Syndicate,0,0,2,0,0,2
Hurley and Mandelbaum,0,0,2,0,0,2
Hydro-Cal Industries,0,0,2,0,0,2
I. B. Nutt,0,0,2,0,0,2
I. L. Burch,0,0,2,0,0,2
"I. X. L. Oil Co., Ltd.",0,0,2,0,0,2
Ibex Oil Co.,0,0,2,0,0,2
Ideal Oil,0,0,2,0,0,2
Imperial Occidental Inc.,0,0,2,0,0,2
Inca Petroleum,0,0,2,0,0,2
Industrial Oil Synd. #3,0,0,2,0,0,2
Inland Resources Co.,0,0,2,0,0,2
International Oil & Gas Co.,0,0,2,0,0,2
International Oil Ventures,0,0,2,0,0,2
"International Petro. Corp., Ltd.",0,0,2,0,0,2
Isco Petro. Corp.,0,0,2,0,0,2
Iseminger Bros.,0,0,2,0,0,2
Ivan J. Vojvoda,0,0,2,0,0,2
J & E Production Co. Ltd.,0,0,2,0,0,2
J & M Operators,0,0,2,0,0,2
J M T Oil Co.,0,0,2,0,0,2
J. & S. Exploration Co.,0,0,2,0,0,2
J. A. Foreman and Dan Foreman,0,0,2,0,0,2
J. B. Cox & Alice C. Cox,0,0,2,0,0,2
J. B. Deuel & C. G. Storie,0,0,2,0,0,2
J. C. Copeland,0,0,2,0,0,2
J. D Rush Co.,0,0,2,0,0,2
J. D. Rush Company,0,0,2,0,0,2
J. E. Johnson Co.,0,0,2,0,0,2
J. F. Hill & Associates,0,0,2,0,0,2
J. F. McMahon,0,0,2,0,0,2
J. H. Thornber and Rio Bravo Pioneer Oil Company,0,0,2,0,0,2
J. J. Tavis,0,0,2,0,0,2
J. J. Tavis and Associates,0,0,2,0,0,2
"J. L. M. & Associates, Inc.",0,0,2,0,0,2
J. L. Smith & R. H. Larsen,0,0,2,0,0,2
"J. L. Smith, Operator",0,0,2,0,0,2
J. M. Ackerman,0,0,2,0,0,2
J. N. Bissell,0,0,2,0,0,2
J. O. Hopper et al,0,0,2,0,0,2
J. T. Holland,0,0,2,0,0,2
J. W. Dietzel,0,0,2,0,0,2
J. W. Rice & L. K. Firestone,0,0,2,0,0,2
"Jack Herley, Operator",0,0,2,0,0,2
Jack L. Watkins,0,0,2,0,0,2
Jack Owens Service Co.,0,0,2,0,0,2
Jack Wright,0,0,2,0,0,2
Jacob F. Kaar,0,0,2,0,0,2
Jalama Oil & Devl Co.,0,0,2,0,0,2
James B. Barnes,0,0,2,0,0,2
James C. McGarry,0,0,2,0,0,2
James Ebert & Edward Nepple,0,0,2,0,0,2
James F. B. Richards,0,0,2,0,0,2
James Lee Aydelott,0,0,2,0,0,2
James P. Psaltis,0,0,2,0,0,2
James R. Wylie,0,0,2,0,0,2
James S. Hull,0,0,2,0,0,2
JB Operating Co.,0,0,2,0,0,2
JDT Production Co.,0,0,2,0,0,2
Jefferson Oil Co.,0,0,2,0,0,2
Jennings and Reese,0,0,2,0,0,2
Jesse M. Butler,0,0,2,0,0,2
Jewel City Expl.,0,0,2,0,0,2
Jim Riley,0,0,2,0,0,2
John & Floreine Hudspeth,0,0,2,0,0,2
"John Baldwin, Oper.",0,0,2,0,0,2
John Knudsen & Oscar E. Schmidt,0,0,2,0,0,2
John M. & W. F. Rohrig,0,0,2,0,0,2
"John P. Wallace, Operator",0,0,2,0,0,2
John Pirie,0,0,2,0,0,2
John Q. Tannehill,0,0,2,0,0,2
John W. Alford,0,0,2,0,0,2
John Wayne,0,0,2,0,0,2
Johnny Brown,0,0,2,0,0,2
Jose Oil Co.,0,0,2,0,0,2
"Joseph A. Tarver, Oper.",0,0,2,0,0,2
Joseph C Kimble Opr,0,0,2,0,0,2
Joseph F. Zottarelli,0,0,2,0,0,2
Joseph M Thomas,0,0,2,0,0,2
"Joseph M. Thomas, Operator",0,0,2,0,0,2
Josephine Scott Crocker,0,0,2,0,0,2
Joyce J. Brown,0,0,2,0,0,2
"JT Moore Realty, LLC",0,0,2,0,0,2
Julian S. Gould,0,0,2,0,0,2
Julio V. Dougherty & Assoc.,0,0,2,0,0,2
Julius S. Beck,0,0,2,0,0,2
"Jupiter Oil Co., Ltd",0,0,2,0,0,2
Justice & Ellerby,0,0,2,0,0,2
Justin S. Snow,0,0,2,0,0,2
K. & G. Drilling Company,0,0,2,0,0,2
K. S. Deeds,0,0,2,0,0,2
Kabella Oil Co.,0,0,2,0,0,2
"Kaiser Foundation Health Plan, Inc.",0,0,2,0,0,2
"KAMCO, Inc.",0,0,2,0,0,2
Keck Syndicate #5,0,0,2,0,0,2
Kendon Petroleum Company,0,0,2,0,0,2
Kenneth H. Hunter Jr. Assoc,0,0,2,0,0,2
Kenneth K. Lowell,0,0,2,0,0,2
Kenneth L Switzer,0,0,2,0,0,2
Kenneth M. Bennett,0,0,2,0,0,2
Kern Hills Oil Co.,0,0,2,0,0,2
Kern Petroleum Corp.,0,0,2,0,0,2
Kern Valley Drilling Co.,0,0,2,0,0,2
Kerngas Associates,0,0,2,0,0,2
Kernland Oil Company,0,0,2,0,0,2
Kerntaft Petroleum Co.,0,0,2,0,0,2
Kernview Oil Corporation,0,0,2,0,0,2
Kettner Res. Inc,0,0,2,0,0,2
Keystone Consolidated Oil Co.,0,0,2,0,0,2
Kimble Oil Company,0,0,2,0,0,2
Knolls Construction Co.,0,0,2,0,0,2
Kohlbush & Lyons,0,0,2,0,0,2
Kolingo Drilling Co.,0,0,2,0,0,2
Kova-Pet Associates,0,0,2,0,0,2
Kovell Oil Co.,0,0,2,0,0,2
L. A. Thomson,0,0,2,0,0,2
L. B. Armstrong,0,0,2,0,0,2
L. C. Smitherman,0,0,2,0,0,2
L. H. Cameron,0,0,2,0,0,2
L. H. Glaser,0,0,2,0,0,2
L. J. Kirk & Harry Pieksma,0,0,2,0,0,2
L. L. Ellis & M. U. Stanford,0,0,2,0,0,2
L. P. Reischman,0,0,2,0,0,2
L. R. E. Oil Co.,0,0,2,0,0,2
L. R. Knowlton,0,0,2,0,0,2
L. R. Wilhite,0,0,2,0,0,2
La Brea Oil Co.,0,0,2,0,0,2
La Canada Oil Corp.,0,0,2,0,0,2
La Honda Oil Fields Assoc.,0,0,2,0,0,2
La Liebre Oil Co.,0,0,2,0,0,2
Lacal Oil Corp. and Lyle A. Garner,0,0,2,0,0,2
Laguna Consolidated Oil Co.,0,0,2,0,0,2
Lake View Oil & Refining Co.,0,0,2,0,0,2
Landsea Construction LLC,0,0,2,0,0,2
"Langdell, Newmark & Rowan",0,0,2,0,0,2
Langford Oil & Gas Co.,0,0,2,0,0,2
Larlo Oil Co.,0,0,2,0,0,2
Larry E. Bedrosian,0,0,2,0,0,2
"Latimer Pictures, Inc.",0,0,2,0,0,2
"Laurence A. Green, Oper.",0,0,2,0,0,2
Lawrence P. Kraemer,0,0,2,0,0,2
Lebow-Radin,0,0,2,0,0,2
Lee Westlake,0,0,2,0,0,2
Lehr Co.,0,0,2,0,0,2
Leigh Oil Co. Ltd.,0,0,2,0,0,2
Leon J. Sabean,0,0,2,0,0,2
Leonard & Porter,0,0,2,0,0,2
Lester I Bartlow & John Hetman,0,0,2,0,0,2
Lew Suverkrop,0,0,2,0,0,2
Lewis & Clark Expl. Co.,0,0,2,0,0,2
Lewis Operating Corporation,0,0,2,0,0,2
Lewis Solomon,0,0,2,0,0,2
"Lewis T. Lohman, Oper.",0,0,2,0,0,2
Li-Jo Oil Co.,0,0,2,0,0,2
Liberty Oil Syndicate,0,0,2,0,0,2
Light Dev. Co.,0,0,2,0,0,2
Lightning Gas & Oil Co.,0,0,2,0,0,2
Lionel Freeman,0,0,2,0,0,2
Lipan Oil Co.,0,0,2,0,0,2
Lipkin & Devine,0,0,2,0,0,2
Lit Oil Co.,0,0,2,0,0,2
Little and Gilstrap,0,0,2,0,0,2
Little Cuyama Oil Co.,0,0,2,0,0,2
Lockwood Valley Oil Co.,0,0,2,0,0,2
Lomi Oil Corp.,0,0,2,0,0,2
Lompoc Oil & Devl Co.,0,0,2,0,0,2
Long & Bell,0,0,2,0,0,2
Long Beach Harbor Dept.,0,0,2,0,0,2
"Long Beach Petroleum Co., Ltd.",0,0,2,0,0,2
Loon Point Oil Co.,0,0,2,0,0,2
Los Angeles Basin Drilling Co.,0,0,2,0,0,2
Love Oil Co. Inc.,0,0,2,0,0,2
Luneta Oil Co.,0,0,2,0,0,2
Lyle A. Garner & Assoc.,0,0,2,0,0,2
M & A Oil Co.,0,0,2,0,0,2
M. A. Fields & S.E. Madar et al,0,0,2,0,0,2
M. E. & Frank Silva Co.,0,0,2,0,0,2
"M. E. Mallett, O R Huber &",0,0,2,0,0,2
M. H. Bush & W. M. Webb,0,0,2,0,0,2
M. K. Doumani,0,0,2,0,0,2
M. K. Energy,0,0,2,0,0,2
M. R. A. Syndicate,0,0,2,0,0,2
M. T. M. Oil Company,0,0,2,0,0,2
M. W. Southard,0,0,2,0,0,2
MacDonald Lynch,0,0,2,0,0,2
Machii-Ross Petroleum Co,0,0,2,0,0,2
Mack Oil Co.,0,0,2,0,0,2
Macoil Corp.,0,0,2,0,0,2
Magee & Stone,0,0,2,0,0,2
Maggini Construction Co.,0,0,2,0,0,2
Magnet Oil Co.,0,0,2,0,0,2
Magu Oil Co.,0,0,2,0,0,2
Main Oil Co. of Calif.,0,0,2,0,0,2
Majorol Company,0,0,2,0,0,2
Malco Asphalt & Refining Co.,0,0,2,0,0,2
Marcus-Goldberg,0,0,2,0,0,2
Mark H. Finley,0,0,2,0,0,2
Marland Oil Co. of Calif.,0,0,2,0,0,2
Maurits F. Osterburg,0,0,2,0,0,2
Max A. Newton,0,0,2,0,0,2
Max N. Hammerling,0,0,2,0,0,2
Mayflower Oil Co.,0,0,2,0,0,2
Maylian Oil Company,0,0,2,0,0,2
McCulloch Oil Corp.,0,0,2,0,0,2
McIntyre Bros.,0,0,2,0,0,2
McKean Bros.,0,0,2,0,0,2
McKittrick Petroleum Co.,0,0,2,0,0,2
McMullan & Grother,0,0,2,0,0,2
McVicar-Rood-McCallen,0,0,2,0,0,2
Medal Oil Co.,0,0,2,0,0,2
"Mendell Davis Gas Partners, LLC",0,0,2,0,0,2
"Merel Co., Inc",0,0,2,0,0,2
Metropolis Oil Co.,0,0,2,0,0,2
"Metropolitan Oil Corp., Ltd.",0,0,2,0,0,2
Michael Cannata,0,0,2,0,0,2
Mid-Center Oil Co. Ltd.,0,0,2,0,0,2
Mid-Western Oil Company,0,0,2,0,0,2
Mid Counties Oil Corp.,0,0,2,0,0,2
Middle Dome Corporation,0,0,2,0,0,2
Midstate Consolidated Oil Co.,0,0,2,0,0,2
"Midway Northern Oil and Royalty Corp., Ltd.",0,0,2,0,0,2
Mike Barkett,0,0,2,0,0,2
Miller and Miller,0,0,2,0,0,2
Miller and York Trustees,0,0,2,0,0,2
Milner Oil Co.,0,0,2,0,0,2
Milton A. Prehn,0,0,2,0,0,2
Milton R. Schulz,0,0,2,0,0,2
Mines Oil Co.,0,0,2,0,0,2
Minus E. Jackson,0,0,2,0,0,2
Mitchel Lau,0,0,2,0,0,2
Mitchell Land and Improvement Co.,0,0,2,0,0,2
Mohawk Petroleum Corp.,0,0,2,0,0,2
Mojave Petroleum Co.,0,0,2,0,0,2
Mona P. Cook,0,0,2,0,0,2
Monterey Oil & Gas Expl. Co.,0,0,2,0,0,2
Morganton Oil Co.,0,0,2,0,0,2
Mortara Oil Co.,0,0,2,0,0,2
Morton & Kohlbush,0,0,2,0,0,2
Morton and Dolley and M J M & M Oil Co.,0,0,2,0,0,2
"Morton, Dolley, Campbell & Shell",0,0,2,0,0,2
Mountain States Development Co.,0,0,2,0,0,2
Mountain View Oil Corp.,0,0,2,0,0,2
"Murphy Bros., Ltd.",0,0,2,0,0,2
Mutal Dev. Corp.,0,0,2,0,0,2
Mutz Oil Operator,0,0,2,0,0,2
N. G. Snyder,0,0,2,0,0,2
Nadot Oil Co.,0,0,2,0,0,2
Napetro Producers Syndicate,0,0,2,0,0,2
National Exploration Co.,0,0,2,0,0,2
"Natomas Expl., Inc.",0,0,2,0,0,2
"Ned Barmore, Trustee",0,0,2,0,0,2
Ned Oil Co.,0,0,2,0,0,2
Nedal Oil Co.,0,0,2,0,0,2
Nelson-Phillips Oil Co.,0,0,2,0,0,2
Nelson B. Cramer,0,0,2,0,0,2
Nev-Tah Oil & Mining Co.,0,0,2,0,0,2
New-Lonamen,0,0,2,0,0,2
"New Horizon Exploration, Inc.",0,0,2,0,0,2
New Pennsylvania Pet Co.,0,0,2,0,0,2
Nick Juran,0,0,2,0,0,2
Norman Fuller,0,0,2,0,0,2
North Coalinga Oil Co.,0,0,2,0,0,2
North Coast Oil & Refining Co.,0,0,2,0,0,2
"O'Kane & Brain, Inc.",0,0,2,0,0,2
O. & H. Oil Co.,0,0,2,0,0,2
O. Biller,0,0,2,0,0,2
O. F. Collinge,0,0,2,0,0,2
O. M. Oil Co.,0,0,2,0,0,2
Oceanview Oil Corp.,0,0,2,0,0,2
Oil & Gas Prop Mgmt. Inc.,0,0,2,0,0,2
"Oil Investments, Inc.",0,0,2,0,0,2
Oil Securities and Metals Corp.,0,0,2,0,0,2
Oka Brothers,0,0,2,0,0,2
Okell Well Machinery Co.,0,0,2,0,0,2
Olean Freres Corp.,0,0,2,0,0,2
Oliver H. Covall,0,0,2,0,0,2
Olsen-Oliver,0,0,2,0,0,2
"Olsen Oil, Inc.",0,0,2,0,0,2
Operators No. 1,0,0,2,0,0,2
Orange County Refining Co.,0,0,2,0,0,2
Owen Jackson,0,0,2,0,0,2
Owens & Montgomery,0,0,2,0,0,2
"P. Sesnon, B Sesnon .",0,0,2,0,0,2
Pacific Coast Oil Company,0,0,2,0,0,2
Pacific Oil & Gas Dev. Co.,0,0,2,0,0,2
"Pacific Petroleum, L.L.C.",0,0,2,0,0,2
Pacific Tin Consolidated Corp.,0,0,2,0,0,2
Palisades Petro. Co.,0,0,2,0,0,2
Palm Oil Co.,0,0,2,0,0,2
Palomar Refining Co.,0,0,2,0,0,2
Pamoan Oil Co.,0,0,2,0,0,2
Pan-May Oil Co.,0,0,2,0,0,2
Pan American Petroleum Co.,0,0,2,0,0,2
Parish Bros.,0,0,2,0,0,2
Parlay Oil Company,0,0,2,0,0,2
Pasadena Petroleum Corp.,0,0,2,0,0,2
Patton & Conaway,0,0,2,0,0,2
"Patton & Millar, Trustees",0,0,2,0,0,2
Patton Oil Co.,0,0,2,0,0,2
Paul Beamer,0,0,2,0,0,2
Paul L. Kelley,0,0,2,0,0,2
Peacock Oil Co.,0,0,2,0,0,2
Peerless Consolidated Oil Co.,0,0,2,0,0,2
Peter Del Re Oil Co.,0,0,2,0,0,2
Petersen-Larson and Co.,0,0,2,0,0,2
Petroleum Development Corp.,0,0,2,0,0,2
"Petroleum Drilling & Exploration Co., Inc.",0,0,2,0,0,2
Petrowest,0,0,2,0,0,2
Phelps and Cheney,0,0,2,0,0,2
Philip R. Mcpharlin,0,0,2,0,0,2
Phillips Investment Corp. of Calif.,0,0,2,0,0,2
"Pine Meadows Ranch, Incorporated",0,0,2,0,0,2
Piney Woods Oil Co.,0,0,2,0,0,2
Pioneer Petrol Corp.,0,0,2,0,0,2
Piru Monarch,0,0,2,0,0,2
Planet Oil Co.,0,0,2,0,0,2
POMOCO Inc.,0,0,2,0,0,2
Portals Woodward Joint Venture,0,0,2,0,0,2
Porterville Oil & Gas Inc.,0,0,2,0,0,2
"Poso Creek Energy, LLC",0,0,2,0,0,2
"Powell-Stockton Investment Co., Ltd.",0,0,2,0,0,2
Precision Drilling Co.,0,0,2,0,0,2
"Prime Natural Resources, LLC",0,0,2,0,0,2
Producers Oil Corp. of America,0,0,2,0,0,2
Prosper D. Smith,0,0,2,0,0,2
Prouhet & Troupe,0,0,2,0,0,2
Pueblo Oil Corp.,0,0,2,0,0,2
Queen Oil Co. of California,0,0,2,0,0,2
"Quincy Oils, Ltd.",0,0,2,0,0,2
Quintin R. Grenfell,0,0,2,0,0,2
R. A. Provost Assoc.,0,0,2,0,0,2
R. B. Jackson and Essie L. Jackson,0,0,2,0,0,2
R. E. Bering,0,0,2,0,0,2
R. E. Bletcher,0,0,2,0,0,2
R. H. Strickland & A Tippet,0,0,2,0,0,2
R. M. Smith,0,0,2,0,0,2
R. S. & L. Oil Corp.,0,0,2,0,0,2
R. W. Jerman,0,0,2,0,0,2
Ralph W. Ellithorpe,0,0,2,0,0,2
Rancho Oil Co.,0,0,2,0,0,2
Ranger Oil and Gas Co.,0,0,2,0,0,2
Raymond L. Sarna,0,0,2,0,0,2
RCU  Operator,0,0,2,0,0,2
Recknagel & Mangold Oil Co.,0,0,2,0,0,2
Recknagel Oil Co.,0,0,2,0,0,2
"Red Rock Oil Co., Inc.",0,0,2,0,0,2
Redwood Oil Co.,0,0,2,0,0,2
Reed and Billington,0,0,2,0,0,2
Reef Ridge Oil Co.,0,0,2,0,0,2
"Reid & Berliner, Inc.",0,0,2,0,0,2
"Remora Operating CA, LLC",0,0,2,0,0,2
Republic Petro. Co. Ltd,0,0,2,0,0,2
Resource Partners,0,0,2,0,0,2
Richard R Thorup Opr,0,0,2,0,0,2
Richard S. Miesse,0,0,2,0,0,2
Richard S. Rheem,0,0,2,0,0,2
Richard Steltzner,0,0,2,0,0,2
Richards & Rowan,0,0,2,0,0,2
Richland Oil Co.,0,0,2,0,0,2
Richmond Exploration Corporation,0,0,2,0,0,2
Riddle & Gottlieb,0,0,2,0,0,2
"Ridgewood Industries, Inc.",0,0,2,0,0,2
Ring Petro. Prospect of Yuba Co,0,0,2,0,0,2
Rio Delta Resources,0,0,2,0,0,2
"Road Oil Sales, Inc.",0,0,2,0,0,2
Robert A. Foster,0,0,2,0,0,2
Robert Bromberg-Receiver,0,0,2,0,0,2
Robert Jones,0,0,2,0,0,2
Robert L. Moody,0,0,2,0,0,2
Robert W. Berry Inc.,0,0,2,0,0,2
Rocket Petroleum Company,0,0,2,0,0,2
"Roetnor Oil Co., Ltd.",0,0,2,0,0,2
Roggie-Johnson Drilling Co.,0,0,2,0,0,2
Ronald C. Smith,0,0,2,0,0,2
Rory Oil Co.,0,0,2,0,0,2
Roston & Herbaly Peto. Consultants Ltd,0,0,2,0,0,2
Rothschild-Bender Oil Operations,0,0,2,0,0,2
Roy Gill - Oper.,0,0,2,0,0,2
Roy J. & Doyle Wattenbarger,0,0,2,0,0,2
Royal Resources,0,0,2,0,0,2
Ruhle And Chino Associates,0,0,2,0,0,2
Russel Mann,0,0,2,0,0,2
"Russell Cobb, Jr., Inc.",0,0,2,0,0,2
Ryan Oil Co.,0,0,2,0,0,2
S-S Syndicate,0,0,2,0,0,2
S. D. M. Oil Co.,0,0,2,0,0,2
S. E. I.,0,0,2,0,0,2
S.B.O. & M. Co. Wharf,0,0,2,0,0,2
"SA Properties Company, LP",0,0,2,0,0,2
Sage & Olson,0,0,2,0,0,2
Sage Oil Co Inc,0,0,2,0,0,2
San-Cal Oil & Gas Corp.,0,0,2,0,0,2
San Benito Oil Co.,0,0,2,0,0,2
San Buena Ventura Oil Co.,0,0,2,0,0,2
San Fernando Gas & Oil Co.,0,0,2,0,0,2
San Joaquin Drilling Co.,0,0,2,0,0,2
San Joaquin Operations LLC,0,0,2,0,0,2
San Luis Syndicate,0,0,2,0,0,2
San Martinez Oil Co.,0,0,2,0,0,2
San Miguel Oil & Dev.,0,0,2,0,0,2
Santa Carla Oil Co.,0,0,2,0,0,2
Santa Clara Ltd Partnership,0,0,2,0,0,2
Santa Fe Drilling Company,0,0,2,0,0,2
Santa Fe Energy Company,0,0,2,0,0,2
Santa Paula Oil Co.,0,0,2,0,0,2
"Santos, Oneto & Fabry Exp",0,0,2,0,0,2
Sardi Oil Co.,0,0,2,0,0,2
Savoy Oil Co.,0,0,2,0,0,2
Schaufele & Reynolds,0,0,2,0,0,2
Scott-Jackson,0,0,2,0,0,2
Scott-McIntosh Petro Inc.,0,0,2,0,0,2
Scott & Hendrickson,0,0,2,0,0,2
Secunda Oil Corp.,0,0,2,0,0,2
Security Land & Water Co.,0,0,2,0,0,2
Seguro Petro. Co.,0,0,2,0,0,2
Selegna Pet. Corp.,0,0,2,0,0,2
Sespe Oil Co.,0,0,2,0,0,2
"Shaffer Rentals, Inc.",0,0,2,0,0,2
Shaffer Tools Works,0,0,2,0,0,2
Shannon Oil Co.,0,0,2,0,0,2
Sharby Oil Co.,0,0,2,0,0,2
Shasta Petro. Co.,0,0,2,0,0,2
Shelly Energy Inc.,0,0,2,0,0,2
Sherman F. Wagenseller & John J. August,0,0,2,0,0,2
Shirley M. Lechler,0,0,2,0,0,2
Sierra Petro. Corp. of Oregon,0,0,2,0,0,2
Silver Petro. Co.,0,0,2,0,0,2
Silver Wing Oil Co.,0,0,2,0,0,2
"Simi Oil Co., Ltd.",0,0,2,0,0,2
Sisar Oil & Asphalt Co.,0,0,2,0,0,2
Skaggs Springs Oil & Gas Co.,0,0,2,0,0,2
SM Hydrocarbons Inc.,0,0,2,0,0,2
Smith and Davidson,0,0,2,0,0,2
"Smith International, Inc.",0,0,2,0,0,2
Snowolene Oil Co.,0,0,2,0,0,2
So Cal Drilling Co.,0,0,2,0,0,2
So Cal Petro. Corp.,0,0,2,0,0,2
Solana Oil Co.,0,0,2,0,0,2
Solar Drilling Co.,0,0,2,0,0,2
Solaris Energy Corporation,0,0,2,0,0,2
South Basin Oil Co.,0,0,2,0,0,2
South Lake Farms,0,0,2,0,0,2
South Lake Oil & Gas Inc.,0,0,2,0,0,2
South Pacific Oil Co.,0,0,2,0,0,2
Southern California Petro. Co.,0,0,2,0,0,2
Southern Oil & Gas Company,0,0,2,0,0,2
Southland Royalty Co.,0,0,2,0,0,2
Southwest Oil and Dev. Corp.,0,0,2,0,0,2
Southwest Oil Co.,0,0,2,0,0,2
Southwestern Development Co.,0,0,2,0,0,2
Speik Oil Co.,0,0,2,0,0,2
Spencer D. Coates,0,0,2,0,0,2
Spur Oil Company,0,0,2,0,0,2
St. Michael Exploration Co.,0,0,2,0,0,2
Standard Dehydrating Co.,0,0,2,0,0,2
Stanley E. Kuhns,0,0,2,0,0,2
Stanton Oil Co.,0,0,2,0,0,2
Star Petro. Co.,0,0,2,0,0,2
State Exploration Co.,0,0,2,0,0,2
Stateswide Oil Corp.,0,0,2,0,0,2
Sterling Petro. Co.,0,0,2,0,0,2
"Stocker Resources, Inc.",0,0,2,0,0,2
"Storm Plaza Torrance, LLC",0,0,2,0,0,2
Success Oil Co.,0,0,2,0,0,2
Success Petroleum Company,0,0,2,0,0,2
Sulphur Mountain Petro. Co.,0,0,2,0,0,2
Sun Mountain Oil & Gas,0,0,2,0,0,2
Sundance Oil Co.,0,0,2,0,0,2
Sunland Refining Corp.,0,0,2,0,0,2
Sunwell Oil Co.,0,0,2,0,0,2
T. B. Hess,0,0,2,0,0,2
T. F. Woodward,0,0,2,0,0,2
T. M. Gibson,0,0,2,0,0,2
T. S .Walker,0,0,2,0,0,2
Tampico Petroleum Co.,0,0,2,0,0,2
"Tarr & McComb Oil Co., Ltd.",0,0,2,0,0,2
Tejon Basin Oil Co.,0,0,2,0,0,2
Tejon Exploration Co.,0,0,2,0,0,2
Tejon Oil,0,0,2,0,0,2
Ten Friends Oil Co.,0,0,2,0,0,2
Tenby-Sperry Oil Co.,0,0,2,0,0,2
Tepesquet Oil Corp.,0,0,2,0,0,2
Tepusquet Oil Co.,0,0,2,0,0,2
Termo Co. of Texas,0,0,2,0,0,2
"Terra Bella, Ltd.",0,0,2,0,0,2
"Terreno South Main, LLC",0,0,2,0,0,2
Tex Harvey Oil Co.,0,0,2,0,0,2
Texaco Producing Inc.,0,0,2,0,0,2
"Texaco Producing Inc., Opr.",0,0,2,0,0,2
Texas-Pacific Coal & Oil,0,0,2,0,0,2
Texas General Petroleum Corp.,0,0,2,0,0,2
"Texas Meat Brokerage, Inc.",0,0,2,0,0,2
The 57 Petroleum Corp.,0,0,2,0,0,2
"The Caminol Company, Ltd.",0,0,2,0,0,2
The Escondido Company,0,0,2,0,0,2
The Larutan Corporation,0,0,2,0,0,2
The McKee Co.,0,0,2,0,0,2
The Petro. Co.,0,0,2,0,0,2
The Roman Catholic Archbishop of Los Angeles,0,0,2,0,0,2
Thelma Russell (Miss),0,0,2,0,0,2
Thermal Production Co.,0,0,2,0,0,2
Third Twin Bell Synd.,0,0,2,0,0,2
Thomas C. King,0,0,2,0,0,2
Thomas J. Moore,0,0,2,0,0,2
Thomas P. Pike Drilling Co.,0,0,2,0,0,2
"Thornbury, Geis, & Robinson",0,0,2,0,0,2
Tideland Oil Company,0,0,2,0,0,2
Tierra Oil Co.,0,0,2,0,0,2
Tillman B. Hess,0,0,2,0,0,2
Timco Oil Co.,0,0,2,0,0,2
TJ Ballantyne Living Trust,0,0,2,0,0,2
Todos Santos Oil Co.,0,0,2,0,0,2
Tom D. Harrison,0,0,2,0,0,2
Tom Jones Exploration Co.,0,0,2,0,0,2
Torgon Petroleum Co.,0,0,2,0,0,2
Torrance Syndicate No. 1,0,0,2,0,0,2
Transcal Drilling Co.,0,0,2,0,0,2
Transcontinental Energy Corporation,0,0,2,0,0,2
"Transpac Petroleum, Inc.",0,0,2,0,0,2
"Treasure Drilling Co., Ltd.",0,0,2,0,0,2
Tri-Service Drilling Company,0,0,2,0,0,2
Trueman W. Stansbury,0,0,2,0,0,2
"Tulare Basin Gas Co., Ltd.",0,0,2,0,0,2
Tuolumne River Lodge,0,0,2,0,0,2
Turlock Oil & Gas Co.,0,0,2,0,0,2
Twentieth Century Oil Company,0,0,2,0,0,2
Twin Bell Oil Syndicate,0,0,2,0,0,2
"TWM Petro., Inc.",0,0,2,0,0,2
"Two and One Oil Co., Ltd.",0,0,2,0,0,2
TXP Operating Co.,0,0,2,0,0,2
U. S. Signal 1972 Program Limited,0,0,2,0,0,2
Union Oil Company,0,0,2,0,0,2
United States Geological Survey,0,0,2,0,0,2
V. A. Porter,0,0,2,0,0,2
V. Eugene Burrhus,0,0,2,0,0,2
V. F. Arnold,0,0,2,0,0,2
V. P. Baker,0,0,2,0,0,2
V. R. G. Wilbur Oil,0,0,2,0,0,2
Vallecitos Assoc.,0,0,2,0,0,2
Valley Drilling & Prod. Co.,0,0,2,0,0,2
"Valley Energy Resources, Inc.",0,0,2,0,0,2
"Valley Expl. Co., Ltd.",0,0,2,0,0,2
Valley Nitrogen Producers,0,0,2,0,0,2
Vanguard Oil Co.,0,0,2,0,0,2
Venada Drillco,0,0,2,0,0,2
"Venture Oil & Gas, Inc.",0,0,2,0,0,2
"Verde Ent., Oper. For Kern Prod. Co.",0,0,2,0,0,2
Verde Enterprises Opr,0,0,2,0,0,2
Verlan R. Wyatt,0,0,2,0,0,2
"VICORP, Energy, Inc.",0,0,2,0,0,2
"Victor H. York, Jr",0,0,2,0,0,2
Vincent E. Winel,0,0,2,0,0,2
Vincent F. Stabeck,0,0,2,0,0,2
Vortex Energy & Minerals Ltd.,0,0,2,0,0,2
W. C. Eaton,0,0,2,0,0,2
W. E. Burnett,0,0,2,0,0,2
W. F. Higgins,0,0,2,0,0,2
W. G. Johnson,0,0,2,0,0,2
W. J. Barnhart,0,0,2,0,0,2
W. J. Frick,0,0,2,0,0,2
W. J. Hamilton,0,0,2,0,0,2
W. K. Barker,0,0,2,0,0,2
"W. L. Holmes, Operator",0,0,2,0,0,2
W. R. Ude & Co.,0,0,2,0,0,2
"W. S. Payne, Jr., & Assoc.",0,0,2,0,0,2
Wallace M. Nelson,0,0,2,0,0,2
Walter and Goodell,0,0,2,0,0,2
Walter De Courcy,0,0,2,0,0,2
Walter E. Schmidt,0,0,2,0,0,2
Walter H. Fisher Corp.,0,0,2,0,0,2
Wane Oil Co.,0,0,2,0,0,2
Warren and Macrate,0,0,2,0,0,2
Warren L. Meeker,0,0,2,0,0,2
Watkins and McFarland,0,0,2,0,0,2
Watkins and Tunstall,0,0,2,0,0,2
Weaver & Weaver,0,0,2,0,0,2
Webb Oil Co.,0,0,2,0,0,2
Weldon Oil Co.,0,0,2,0,0,2
Wesco Oil Co.,0,0,2,0,0,2
Wesley West,0,0,2,0,0,2
"West Coast Pet. Combinations, Inc.",0,0,2,0,0,2
Western Coast Oil Co.,0,0,2,0,0,2
"Western Oil Royalties, Ltd.",0,0,2,0,0,2
Western Union Oil Co.,0,0,2,0,0,2
Westlake Rommel,0,0,2,0,0,2
Wico Oil Co.,0,0,2,0,0,2
William & Ruth Gilmore,0,0,2,0,0,2
William Hughes,0,0,2,0,0,2
William K. Barker & Associates,0,0,2,0,0,2
"William P. Hicks, Operator",0,0,2,0,0,2
William Y. Lee,0,0,2,0,0,2
"Williams, Sumpf, Ferguson",0,0,2,0,0,2
Willis Joint Venture,0,0,2,0,0,2
Wilson-Fairfield,0,0,2,0,0,2
Windsor Energy,0,0,2,0,0,2
Windsor Oil Co.,0,0,2,0,0,2
Wishon-Watson Co.,0,0,2,0,0,2
Wm. M. Thornbury,0,0,2,0,0,2
"Wm. M. Thornbury, Operator",0,0,2,0,0,2
"Wm. Thornbury, Inc.",0,0,2,0,0,2
Woodland Oil Co.,0,0,2,0,0,2
"Woodland Oil Co., Opr.",0,0,2,0,0,2
Woods Petro. Corp.,0,0,2,0,0,2
Worldwide Pacific Corp.,0,0,2,0,0,2
Z. L. Phelps,0,0,2,0,0,2
Zia-Yolo,0,0,2,0,0,2
Zompac Corp.,0,0,2,0,0,2
"Kebo Oil & Gas, Inc.",0,0,1,1,0,2
"Valley Resources, LLC",0,0,1,1,0,2
777 Energy LLC,0,0,0,2,0,2
Tulare Oil & Mining Company,0,0,0,0,2,2
Ann Brindle,1,0,0,0,0,1
B5 Holdings LLC,1,0,0,0,0,1
Black Gold Valve Company LLC,1,0,0,0,0,1
Brayton-Hodges Petroleum Inc.,1,0,0,0,0,1
C & J Oil,1,0,0,0,0,1
"C&J Well Services, Inc.",1,0,0,0,0,1
Chaim Nathan & Edie Bato,1,0,0,0,0,1
City of Los Angeles,1,0,0,0,0,1
"Garner Engineering, Inc.",1,0,0,0,0,1
"Herley Olive Holdings, LLC",1,0,0,0,0,1
Laguna County Sanitation District,1,0,0,0,0,1
M & J Operator,1,0,0,0,0,1
Mitchell-Grossu Oil Co.,1,0,0,0,0,1
Old Field Associates,1,0,0,0,0,1
P. C. Oil Company,1,0,0,0,0,1
Petrojen Production Company,1,0,0,0,0,1
Reef Ridge Energy Company LLC,1,0,0,0,0,1
"Rountree/Wright Enterprises, LLC",1,0,0,0,0,1
"Temple Resources, LLC",1,0,0,0,0,1
"TJ Scott Family Investments, LLC",1,0,0,0,0,1
West Bay Exploration Company,1,0,0,0,0,1
Wilco-Placentia Oil Operator LLC,1,0,0,0,0,1
"3MB Oil & Gas, LLC",0,1,0,0,0,1
A. A. Craig,0,1,0,0,0,1
A. B. Dodd,0,1,0,0,0,1
A. D. Kneuper,0,1,0,0,0,1
A. M. Kupfer,0,1,0,0,0,1
A. T. Currier,0,1,0,0,0,1
A. T. Krauss & L. E. Bayer,0,1,0,0,0,1
Alanson Co.,0,1,0,0,0,1
"Albert E. Weiss, Jr.",0,1,0,0,0,1
Alpine Petro.,0,1,0,0,0,1
American Oil Syndicate,0,1,0,0,0,1
Anchor Petroleum Co.,0,1,0,0,0,1
Andrew L. Newkirk,0,1,0,0,0,1
Are-Bee Oil Syndicate No. 2,0,1,0,0,0,1
Artesia Oil Co. of California,0,1,0,0,0,1
Artic Oil Co.,0,1,0,0,0,1
Associated Oil Syndicate,0,1,0,0,0,1
Austin Well,0,1,0,0,0,1
B & L Pump & Supply Company,0,1,0,0,0,1
B. J. Jeffrey,0,1,0,0,0,1
B.A.L. Oil Co.,0,1,0,0,0,1
Baby King Oil Co.,0,1,0,0,0,1
Badger Creek Ltd.,0,1,0,0,0,1
Balboa Oil Co.,0,1,0,0,0,1
Bardsdale Oil Co.,0,1,0,0,0,1
Bartolo Oil Co.,0,1,0,0,0,1
Beach Oil,0,1,0,0,0,1
Beaumont Riverside Oil. Synd.,0,1,0,0,0,1
Belle Vernon,0,1,0,0,0,1
Bernard Oil Co.,0,1,0,0,0,1
Big Basin Paraffin Oil Co.,0,1,0,0,0,1
Bixby Ranch,0,1,0,0,0,1
Black Diamond Oil Co.,0,1,0,0,0,1
Black Wolf Canon Oil Co.,0,1,0,0,0,1
Brady 8 Well Syndicate,0,1,0,0,0,1
Brady 8 Well Syndicate No 2,0,1,0,0,0,1
Brady Sure Shot Oil Co.,0,1,0,0,0,1
"Bridge Point Carson, LLC",0,1,0,0,0,1
Bruce Waring,0,1,0,0,0,1
Buena Ventura Oil Co.,0,1,0,0,0,1
Buena Vista Oil,0,1,0,0,0,1
Burbank Oil Co.,0,1,0,0,0,1
Bureau of Land Mgmnt.,0,1,0,0,0,1
Burlingham Trust No. 1,0,1,0,0,0,1
Burt T. Wells,0,1,0,0,0,1
C. A. Lawrence,0,1,0,0,0,1
C. Bell,0,1,0,0,0,1
C. C. Leslie,0,1,0,0,0,1
C. C. Stall Oil Association,0,1,0,0,0,1
C. M. Flickinger,0,1,0,0,0,1
C. O. Jaggers Co.,0,1,0,0,0,1
C. S. Summar,0,1,0,0,0,1
C. Sharon,0,1,0,0,0,1
C.M. Cotton-V.L. Fleming,0,1,0,0,0,1
Cabazon Central Oil Co.,0,1,0,0,0,1
California-Eastern Oil Co.,0,1,0,0,0,1
California Newhall Oil Co.,0,1,0,0,0,1
Calmateo Petro. Corp.,0,1,0,0,0,1
Calny Oil Co.,0,1,0,0,0,1
Cambria Syndicates,0,1,0,0,0,1
Cantua Oil Co.,0,1,0,0,0,1
Capell Oil Corp.,0,1,0,0,0,1
Capitol Oil Co.,0,1,0,0,0,1
Cardiff Oil Corp.,0,1,0,0,0,1
"Carleton, Nelles & Greer",0,1,0,0,0,1
Carlton Petro. Co.,0,1,0,0,0,1
Central Heights Oil Co. Ltd.,0,1,0,0,0,1
Chalk Cliff Limited,0,1,0,0,0,1
Charles E. Clinton,0,1,0,0,0,1
Charles K. Henry Oil Co.,0,1,0,0,0,1
Charles T. B. Jones,0,1,0,0,0,1
Chas B. Behr Oil Synd.,0,1,0,0,0,1
Chas E. Foster,0,1,0,0,0,1
Chas. Fickert,0,1,0,0,0,1
Chas. McFadden,0,1,0,0,0,1
Chem-Rex Complex Inc.,0,1,0,0,0,1
Cheney Oil Lease Synd.,0,1,0,0,0,1
Chicago Petro. Co.,0,1,0,0,0,1
Chino Valley Beet Sugar Co.,0,1,0,0,0,1
Church Minor Syndicate,0,1,0,0,0,1
Churchill & Weber,0,1,0,0,0,1
Circle Oil & Gas Co.,0,1,0,0,0,1
Citizens Oil & Land Corp.,0,1,0,0,0,1
Clearwater Oil Co. Ltd.,0,1,0,0,0,1
Cline & Clemson,0,1,0,0,0,1
Clyde DeLano,0,1,0,0,0,1
Co-Operative Petro. Synd.,0,1,0,0,0,1
Coalinga Lake View Oil Co.,0,1,0,0,0,1
Coalinga Midland,0,1,0,0,0,1
Colan Development Corp. Ltd.,0,1,0,0,0,1
Colton Terrace Oil Co.,0,1,0,0,0,1
Commercial Refining Co.,0,1,0,0,0,1
Commercial Supply Co.,0,1,0,0,0,1
Commonwealth Oil Company,0,1,0,0,0,1
Community Oil Co. of Nevada,0,1,0,0,0,1
Cordary-Thorpe Trust,0,1,0,0,0,1
Corona Oil Co.,0,1,0,0,0,1
"Crain Orchards, Inc.",0,1,0,0,0,1
"Crinklaw, Smith, & Larson",0,1,0,0,0,1
Crown of the Valley Oil Co.,0,1,0,0,0,1
Cudahay Community Oil Association,0,1,0,0,0,1
Cunningham Oil Co.,0,1,0,0,0,1
D. M. Anderson,0,1,0,0,0,1
D. W. M. Corp.,0,1,0,0,0,1
D.D. Dunlap & John F. Tracey,0,1,0,0,0,1
Daggett & Fletcher,0,1,0,0,0,1
Dave Ebersole Oil Syndicate,0,1,0,0,0,1
Davenport Oil & Gas Development Co.,0,1,0,0,0,1
"De Turk, Martha",0,1,0,0,0,1
"Diversified Resources, LLC",0,1,0,0,0,1
Doheny & Common,0,1,0,0,0,1
"Domain Development Corp., Ltd.",0,1,0,0,0,1
Don L. Francis,0,1,0,0,0,1
Doran Oil Co.,0,1,0,0,0,1
Downey Syndicate,0,1,0,0,0,1
Dr. J. S. Moore,0,1,0,0,0,1
Drexel Clarkston,0,1,0,0,0,1
Dryden Oil Co.,0,1,0,0,0,1
"Duncan Oil Corp., Ltd.",0,1,0,0,0,1
Duplex Pet Corp.,0,1,0,0,0,1
E. D. Taylor Oil Syndicate #1,0,1,0,0,0,1
E. J. Piatt,0,1,0,0,0,1
E. P. Clark,0,1,0,0,0,1
E. U. Combs,0,1,0,0,0,1
Easton & Smith et al,0,1,0,0,0,1
Empire Drilling Co.,0,1,0,0,0,1
Energy Expl. Co. Inc.,0,1,0,0,0,1
Estate of Harold C. Morton,0,1,0,0,0,1
Eugene E. McCool,0,1,0,0,0,1
Ewing Irrigation Products Inc.,0,1,0,0,0,1
Explorers Drilling Co.,0,1,0,0,0,1
F. A. Rife & Co.,0,1,0,0,0,1
F. C. Rhodes,0,1,0,0,0,1
F. E. Fairfield & A. D. Mitchell,0,1,0,0,0,1
F. F. Hoard,0,1,0,0,0,1
F. H. Rowley,0,1,0,0,0,1
F. Leslie Meeker,0,1,0,0,0,1
Ferguson-Francisco Petro. Co.,0,1,0,0,0,1
Ferndale Oil & Petro. Co.,0,1,0,0,0,1
First National Petro. Co.,0,1,0,0,0,1
Five Hundred Oil & Refine Club,0,1,0,0,0,1
Five Star Oil Co.,0,1,0,0,0,1
Fleisher Oil Co.,0,1,0,0,0,1
Floyd Amundson,0,1,0,0,0,1
Ford & Eves Synd.,0,1,0,0,0,1
Forest Gray Energy,0,1,0,0,0,1
Frank A. Andrews & Assoc.,0,1,0,0,0,1
Frank Knapp,0,1,0,0,0,1
Frank W. Royer,0,1,0,0,0,1
Franklin H. Hamilton,0,1,0,0,0,1
Fred A. Ballin,0,1,0,0,0,1
Fred A. Ballin & Fred Erwing,0,1,0,0,0,1
"Fred W. Heath, Trustee",0,1,0,0,0,1
Frogville Exploration & Development LLC,0,1,0,0,0,1
"G. H. Hadley, Jr.",0,1,0,0,0,1
G. W. Cheatham,0,1,0,0,0,1
Gardner & Company,0,1,0,0,0,1
Geo. C. Knoop,0,1,0,0,0,1
George B. Barnes,0,1,0,0,0,1
George W. Hoyt,0,1,0,0,0,1
Gilbert Petroleum Interests Inc.,0,1,0,0,0,1
Glenn Gas Inc.,0,1,0,0,0,1
Glenn Woodward,0,1,0,0,0,1
"Gold Coast Holdings, LLC",0,1,0,0,0,1
"Golden Bee, Inc.",0,1,0,0,0,1
Golden State Oil Co.,0,1,0,0,0,1
Gordon Coop,0,1,0,0,0,1
Grador Oil Co.,0,1,0,0,0,1
Graham Sisters,0,1,0,0,0,1
Guaranty Oil Co.,0,1,0,0,0,1
Guy Powell,0,1,0,0,0,1
H & T Syndicate,0,1,0,0,0,1
H. & G. Oil Co.,0,1,0,0,0,1
H. C. Hicks,0,1,0,0,0,1
H. C. S. Oil Co.,0,1,0,0,0,1
H. C. Turnham,0,1,0,0,0,1
H. H. McClintock Co.,0,1,0,0,0,1
H. L. & W.P. Bidelman,0,1,0,0,0,1
H. L. Hall et al,0,1,0,0,0,1
H. L. Whiston & Co.,0,1,0,0,0,1
H. S. Sewell & Co.,0,1,0,0,0,1
H. T. & K. Syndicate,0,1,0,0,0,1
H. W. Nall,0,1,0,0,0,1
H.H. Lecain,0,1,0,0,0,1
"H2O-CH4, LLC",0,1,0,0,0,1
Hall Petro. Corp.,0,1,0,0,0,1
Hanners Oil Co.,0,1,0,0,0,1
Harris Rogalske,0,1,0,0,0,1
Harry B. Mortimer & R. L. Rasmussen,0,1,0,0,0,1
Harry J. Keeley,0,1,0,0,0,1
Hemet Petroleum Corp.,0,1,0,0,0,1
Henry Renshaw Dabney,0,1,0,0,0,1
Henry Whitcup,0,1,0,0,0,1
Herndon & Hunter,0,1,0,0,0,1
Hibernia Oil Co.,0,1,0,0,0,1
"Hollywood Park Retail/Commercial Investors, LLC",0,1,0,0,0,1
"Homer C. Mills, Inc.",0,1,0,0,0,1
Hualde Ranch Co.,0,1,0,0,0,1
Hubble Oil Co.,0,1,0,0,0,1
Hughes Drilling Co.,0,1,0,0,0,1
Hull Brennan Syndicate,0,1,0,0,0,1
Huntington Diamond Oil Co.,0,1,0,0,0,1
Huntington Midway Crude Oil Co.,0,1,0,0,0,1
Huntington Owners Oil Co.,0,1,0,0,0,1
Huntington Union Gas & Oil Co.,0,1,0,0,0,1
I. H. Preston,0,1,0,0,0,1
I. Rosenblum et al,0,1,0,0,0,1
Imperial Valley Oil & Dev. Assoc.,0,1,0,0,0,1
Imperial Valley Petro. Corp.,0,1,0,0,0,1
Industrial Oil Synd. #5,0,1,0,0,0,1
Interstate Petro. Synd. #1,0,1,0,0,0,1
Italian Vineyard Co.,0,1,0,0,0,1
J-P Oil Co.,0,1,0,0,0,1
J. A. Smith & F. R. Williams,0,1,0,0,0,1
J. C. Marquardt,0,1,0,0,0,1
J. C. Pollock,0,1,0,0,0,1
J. D. Hunt,0,1,0,0,0,1
J. H. Cochran,0,1,0,0,0,1
J. H. Dennis,0,1,0,0,0,1
J. H. Smith,0,1,0,0,0,1
J. Korber,0,1,0,0,0,1
J. M. Hale,0,1,0,0,0,1
J. P. Chandler & Lee Staton,0,1,0,0,0,1
J. W. Alford,0,1,0,0,0,1
J.B. Hebrick,0,1,0,0,0,1
J.H. Roth,0,1,0,0,0,1
Jacques Oil Co.,0,1,0,0,0,1
James E. Johnson,0,1,0,0,0,1
James Sherman & Dennis Weese,0,1,0,0,0,1
Jeffrey Overton & Halfhill,0,1,0,0,0,1
Jesse Yarnell,0,1,0,0,0,1
Joe Gellen,0,1,0,0,0,1
John A. Thomas & Linda Thomas,0,1,0,0,0,1
John Charters,0,1,0,0,0,1
John E. Otto,0,1,0,0,0,1
John H. Chamness,0,1,0,0,0,1
John Kenneth Wehrman,0,1,0,0,0,1
Jones & Stakel,0,1,0,0,0,1
Jordan & Maney,0,1,0,0,0,1
Jordan Crude Oil Co.,0,1,0,0,0,1
Joseph H. Duncan,0,1,0,0,0,1
Joseph L. Herron,0,1,0,0,0,1
Julian Oil Well Pump Co.,0,1,0,0,0,1
K. A. P. Oil Co.,0,1,0,0,0,1
K. L. Smith,0,1,0,0,0,1
K. W. Wing,0,1,0,0,0,1
Keck & Hall,0,1,0,0,0,1
Keck Syndicate #6,0,1,0,0,0,1
Keystone-Montebello Oil Co.,0,1,0,0,0,1
Kirkpatrick Syndicate 2 & 3,0,1,0,0,0,1
Klokke Investment Co.,0,1,0,0,0,1
Klondyke Oil Co.,0,1,0,0,0,1
Kohlbush & Johnston,0,1,0,0,0,1
Kore Energy LLC,0,1,0,0,0,1
L. A. Lambert Oil Synd. #3,0,1,0,0,0,1
L. E. Belger,0,1,0,0,0,1
L. E. Smith,0,1,0,0,0,1
L. Overbaugh & Rufus Choate,0,1,0,0,0,1
L. T. Edwards,0,1,0,0,0,1
L. W. Thomas,0,1,0,0,0,1
La Costa Oil Co.,0,1,0,0,0,1
La Habra Valley Land & Water Co.,0,1,0,0,0,1
Laguna Beach Oil Assn.,0,1,0,0,0,1
Lake County Drilling & Dev. Co.,0,1,0,0,0,1
Las Virgenes Petroleum Co.,0,1,0,0,0,1
Law and  Sanders,0,1,0,0,0,1
Lawrence Santa Fe Oil Co.,0,1,0,0,0,1
Le Fe Oil Co.,0,1,0,0,0,1
Le Tengo Oil Co.,0,1,0,0,0,1
Leo Stein,0,1,0,0,0,1
Lighthouse Oil Co.,0,1,0,0,0,1
Lincoln Oil Synd. No. 1,0,1,0,0,0,1
Linda Vista Oil Co.,0,1,0,0,0,1
"Liu, Cheng and Lin",0,1,0,0,0,1
Live Oak Limited,0,1,0,0,0,1
Livermore & Phelps,0,1,0,0,0,1
Long Beach Consolidated Co.,0,1,0,0,0,1
Long Beach Petro. Syndicate,0,1,0,0,0,1
Los Angeles Harbor Oil Dev. Co.,0,1,0,0,0,1
Los Nogales Co.,0,1,0,0,0,1
Lost Hills-Hanford Oil Co.,0,1,0,0,0,1
Lyle W. rucker,0,1,0,0,0,1
Lynes Oil Syndicate,0,1,0,0,0,1
"Lynwood Consolidated Oil Interest, Inc.",0,1,0,0,0,1
Lyon Brothers,0,1,0,0,0,1
M. G. & N.,0,1,0,0,0,1
M. P. MacMillan,0,1,0,0,0,1
M.L.C.R. Co.,0,1,0,0,0,1
M.T. Oil Co.,0,1,0,0,0,1
Macrom Oil Co.,0,1,0,0,0,1
Mahala Oil & Gas Co.,0,1,0,0,0,1
Main Oil Well Supply Co.,0,1,0,0,0,1
Majestic Oil Co.,0,1,0,0,0,1
Malin No. 1 Trust #509,0,1,0,0,0,1
Mariana Petro. Corp.,0,1,0,0,0,1
Mars Oil Co.,0,1,0,0,0,1
Masco Oil Co.,0,1,0,0,0,1
Maurice Yates,0,1,0,0,0,1
Mauro J. Dentino,0,1,0,0,0,1
MC Energy Holdings LLC,0,1,0,0,0,1
McAlpine Petro. Corp.,0,1,0,0,0,1
McBroom Oil Co.,0,1,0,0,0,1
McKittrick Ltd.,0,1,0,0,0,1
McMahon & McDonald,0,1,0,0,0,1
Mesa Oil & Gas Co.,0,1,0,0,0,1
"Mex Cal Oil & Refining Co.,Ltd",0,1,0,0,0,1
Mid-Rich Drilling Co. Inc.,0,1,0,0,0,1
Midstate Oil Co.,0,1,0,0,0,1
Midway Oil Syndicate,0,1,0,0,0,1
Miller & Haley,0,1,0,0,0,1
Mills Petro. Co.,0,1,0,0,0,1
"Mineral Exploration Co., Ltd.",0,1,0,0,0,1
Mission Bay Oil Co.,0,1,0,0,0,1
Mission Valley Oil Enterprise,0,1,0,0,0,1
Mizpah Oil Co.,0,1,0,0,0,1
Mohla Oil Co.,0,1,0,0,0,1
Monarch Oil,0,1,0,0,0,1
Montana Petro. Corp.,0,1,0,0,0,1
Monterey Park Petroleum Corp.,0,1,0,0,0,1
Montijo & Johnson,0,1,0,0,0,1
Moreno Oil Co.,0,1,0,0,0,1
Morgan Petro. Corp.,0,1,0,0,0,1
Motor Oil & Refining Co.,0,1,0,0,0,1
Mrs. Emma Summers,0,1,0,0,0,1
Muriel Oil Co.,0,1,0,0,0,1
Myrwane Oil Corp.,0,1,0,0,0,1
Nancy E. Anthony,0,1,0,0,0,1
National City Oil Co.,0,1,0,0,0,1
National Consolidated Pet. Co.,0,1,0,0,0,1
Native Petroleum Corp.,0,1,0,0,0,1
New York California Oil Co.,0,1,0,0,0,1
"NewBridge Resources, LLC",0,1,0,0,0,1
Newhall Mountain Oil Co.,0,1,0,0,0,1
Norswing & Halvorson,0,1,0,0,0,1
Northland Oil Co.,0,1,0,0,0,1
"Northwest Extension, Inc.",0,1,0,0,0,1
O'Donnell & Wilde,0,1,0,0,0,1
O'Donnell Oil syndicate,0,1,0,0,0,1
O. K. Carr,0,1,0,0,0,1
O. O. Boyd,0,1,0,0,0,1
"O. R. M. Company, Inc.",0,1,0,0,0,1
Oakes & Mead,0,1,0,0,0,1
Occidental Mining & Petro. Co.,0,1,0,0,0,1
Oceanside Oil & Gas Synd.,0,1,0,0,0,1
Oil Operators Inc.,0,1,0,0,0,1
Oil Well Abandoning Co.,0,1,0,0,0,1
Ojai Oil,0,1,0,0,0,1
Olive-Ventura Oil Corp.,0,1,0,0,0,1
Omeco Oil Co.,0,1,0,0,0,1
Orange Community Oil Association,0,1,0,0,0,1
Orange County Petroleum Co.,0,1,0,0,0,1
Otay Oil Co.,0,1,0,0,0,1
Otis G. Andrews & Sons,0,1,0,0,0,1
Overthrust Exploration Inc,0,1,0,0,0,1
P. C. Higgins,0,1,0,0,0,1
P. H. Osborne,0,1,0,0,0,1
P. M. Peterson,0,1,0,0,0,1
Pacific Corp.,0,1,0,0,0,1
Pacific States Oil Co.,0,1,0,0,0,1
Pacific Union Oil Co.,0,1,0,0,0,1
Palm City Oil Co.,0,1,0,0,0,1
Pass Exploration,0,1,0,0,0,1
Paxton Gold Bond Oil Co.,0,1,0,0,0,1
Peninsula Humane Society & SPCA,0,1,0,0,0,1
Penn Drilling Co.,0,1,0,0,0,1
Pennsylvania-Western Oil Co.,0,1,0,0,0,1
Petrodynamics Assoc.,0,1,0,0,0,1
Philip H. McAlmond,0,1,0,0,0,1
"Pincay RE, LLC",0,1,0,0,0,1
Pioneer Oil syndicate,0,1,0,0,0,1
Placentia-Richfield Central Oil Co.,0,1,0,0,0,1
Placentia Oil Co.,0,1,0,0,0,1
Pontiac Oil Co.,0,1,0,0,0,1
Portland Petroleum Corp.,0,1,0,0,0,1
Poso-Moon Oil Co.,0,1,0,0,0,1
Prine Oil Company,0,1,0,0,0,1
Prize Oil & Gas Co.,0,1,0,0,0,1
Producers Holding Co.,0,1,0,0,0,1
Producers Syndicate,0,1,0,0,0,1
Progressive Oil and Refining,0,1,0,0,0,1
Queen City Drilling Co.,0,1,0,0,0,1
Queen City Oil Syndicate #1,0,1,0,0,0,1
R. A. Nickell,0,1,0,0,0,1
R. H. Shannon,0,1,0,0,0,1
R. M. Cole Oil & Gas Synd.,0,1,0,0,0,1
R. Von Cleeve,0,1,0,0,0,1
R. W. Jackson,0,1,0,0,0,1
Reid & Campbell,0,1,0,0,0,1
Rex Anglin Development Co.,0,1,0,0,0,1
"Rich Petroleum Co., Ltd.",0,1,0,0,0,1
Richard T. Grady,0,1,0,0,0,1
Richfield-Yorba Oil Co.,0,1,0,0,0,1
Richfield Consolidated Oil Co.,0,1,0,0,0,1
Richgrove Oil Co.,0,1,0,0,0,1
Rio Bravo Jasmin,0,1,0,0,0,1
Riverside County Oil Co.,0,1,0,0,0,1
RMR Energy Resources,0,1,0,0,0,1
Robert Cannell,0,1,0,0,0,1
Rochester Oil Co.,0,1,0,0,0,1
Rogers & Edwards,0,1,0,0,0,1
Ross & Gibson,0,1,0,0,0,1
Roy Hartman,0,1,0,0,0,1
"Roy Maggart & C.C. Cummings, Trustees",0,1,0,0,0,1
Rushing Oil & Gas Dev. Corp.,0,1,0,0,0,1
Russian Oil Co.,0,1,0,0,0,1
Ruth J. Bishop & Buckeye Union,0,1,0,0,0,1
S. McLauren,0,1,0,0,0,1
Safe Oil Co,0,1,0,0,0,1
Saint Joseph's Hill of Hope,0,1,0,0,0,1
Salton Sea Chemical Products Corp.,0,1,0,0,0,1
Sam N. Lewis,0,1,0,0,0,1
Samuel freeman,0,1,0,0,0,1
San Diego & Imperial Valley Oil Co.,0,1,0,0,0,1
San Diego Gas & Petroleum Corp.,0,1,0,0,0,1
San Diego Sorrento Oil Co.,0,1,0,0,0,1
San Felipe Oil Co.,0,1,0,0,0,1
"San Joaquin Refining Co., Inc.",0,1,0,0,0,1
"San Joaquin Solutions, LLC",0,1,0,0,0,1
San Pedro Oil & Development Co.,0,1,0,0,0,1
San Pedro Oil Co.,0,1,0,0,0,1
Sanita Petroleum Co.,0,1,0,0,0,1
Santa Ana Canyon Dev. Corp.,0,1,0,0,0,1
Santa Clara Oil & Dev. Co.,0,1,0,0,0,1
Santa Fe Ball Oil Co.,0,1,0,0,0,1
Santa Fe Chief Oil synd.,0,1,0,0,0,1
Santa Fe Dome Oil Co. #2,0,1,0,0,0,1
Santa Fe Done Oil Co.,0,1,0,0,0,1
Santa Fe Springs Mutual Oil Syndicate,0,1,0,0,0,1
Scheidel & Osterli Land Co.,0,1,0,0,0,1
Security Oil Syndicate,0,1,0,0,0,1
Selma Oil Co.,0,1,0,0,0,1
Shale Hills Dev. Co.,0,1,0,0,0,1
Shamrock Syndicate,0,1,0,0,0,1
Simeon Tucker & H. R. Taylor,0,1,0,0,0,1
"Simple Storage, LLC",0,1,0,0,0,1
Skyline Oil & Refining Corp.,0,1,0,0,0,1
"Solano Exploration, LLC",0,1,0,0,0,1
"South Bay Oil & Gas Co., Ltd.",0,1,0,0,0,1
Southwest Petroleum Corp.,0,1,0,0,0,1
Southwest Petroleum Syndicate,0,1,0,0,0,1
Southwestern Oil Co.,0,1,0,0,0,1
Southwestern Petr. & Pipe Line Co.,0,1,0,0,0,1
Special Delivery Oil Syndicate #4,0,1,0,0,0,1
Square Deal Syndicate,0,1,0,0,0,1
Stabler Oil Co.,0,1,0,0,0,1
Stanley S. Turner,0,1,0,0,0,1
Stevenson & Repp,0,1,0,0,0,1
Stockholders Oil Co.,0,1,0,0,0,1
Sunrise Consolidated Oil Co.,0,1,0,0,0,1
Supreme Oil & Refining Co.,0,1,0,0,0,1
Suse Seeburg,0,1,0,0,0,1
T. A. Webber,0,1,0,0,0,1
T. F. Gesell,0,1,0,0,0,1
Tavern Oil Co.,0,1,0,0,0,1
"Taylor Oil Co., Ltd.",0,1,0,0,0,1
Tecalote Dome Oil Co.,0,1,0,0,0,1
Tehama Petroleum Corp.,0,1,0,0,0,1
Tepathol Oil Co.,0,1,0,0,0,1
The Arapahoe Petroleum Co.,0,1,0,0,0,1
Thomas Petro. Co.,0,1,0,0,0,1
Thomas Syndicate,0,1,0,0,0,1
Thompson & McNickels,0,1,0,0,0,1
Thompson & Snow,0,1,0,0,0,1
Thompson & Stever,0,1,0,0,0,1
Three for One Special,0,1,0,0,0,1
Todd & Clark,0,1,0,0,0,1
TPC Operating Inc.,0,1,0,0,0,1
Trans-Western Petro. Corp.,0,1,0,0,0,1
Transpacific Oil Corp.,0,1,0,0,0,1
Triangle Oil Syndicate #2,0,1,0,0,0,1
"Tricolor Oil Co., Inc.",0,1,0,0,0,1
Trigonia Oil Co. of Calif.,0,1,0,0,0,1
Tujunga Oil Co.,0,1,0,0,0,1
U. S. Petro. Syndicate,0,1,0,0,0,1
Unity Oil Co.,0,1,0,0,0,1
URMI Oil Co.,0,1,0,0,0,1
Vancouver California,0,1,0,0,0,1
Vincent Petroleum Corp. Ltd.,0,1,0,0,0,1
"Visioncraft Energy, LLC",0,1,0,0,0,1
Vista Del Mar Oil Co.,0,1,0,0,0,1
Volcano Oil Co.,0,1,0,0,0,1
Vosburgh Oil Corp.,0,1,0,0,0,1
W & P.C. Mellena,0,1,0,0,0,1
W. A. Playter,0,1,0,0,0,1
W. F. Traves,0,1,0,0,0,1
W. G. Davis Production & Refinery Corp.,0,1,0,0,0,1
W. H. Clary,0,1,0,0,0,1
W. J. Anson,0,1,0,0,0,1
W. K. Book,0,1,0,0,0,1
W. L. Alexander,0,1,0,0,0,1
W. P. Hanson,0,1,0,0,0,1
W. P. Lasher,0,1,0,0,0,1
W. W. Beldin,0,1,0,0,0,1
W. W. Lange,0,1,0,0,0,1
W.M.C. Oil Co.,0,1,0,0,0,1
Walden Corp.,0,1,0,0,0,1
"Walker, Pearson & McGregor",0,1,0,0,0,1
Warthan Oil Co.,0,1,0,0,0,1
Wasibi Oil Co.,0,1,0,0,0,1
Webfoot Oil Co.,0,1,0,0,0,1
"Welex, A Halliburton Company",0,1,0,0,0,1
West Continental Oil Co.,0,1,0,0,0,1
Western Development Corp.,0,1,0,0,0,1
Western Energy Resources,0,1,0,0,0,1
"Westland Oil, Inc.",0,1,0,0,0,1
Westlands Water District,0,1,0,0,0,1
Westminster Oil Co.,0,1,0,0,0,1
Whittier-Strong Oil Co.,0,1,0,0,0,1
Whittier De Moines Oil Co.,0,1,0,0,0,1
Whittier National Oil Co.,0,1,0,0,0,1
William Edwards,0,1,0,0,0,1
William Mellema & Pearl C. Mellema,0,1,0,0,0,1
Wilmington Consolidated Oil Co.,0,1,0,0,0,1
Windemere Oil Co.,0,1,0,0,0,1
Wing and Skakel,0,1,0,0,0,1
Winters' Club,0,1,0,0,0,1
Winwell Oil Co.,0,1,0,0,0,1
Wm Sullivan,0,1,0,0,0,1
Wm. A. Hallock,0,1,0,0,0,1
Wm. P. Jackson,0,1,0,0,0,1
Woods,0,1,0,0,0,1
Yale Signal Hill Syndicate,0,1,0,0,0,1
"Young Petroleum Corp., Ltd.",0,1,0,0,0,1
1062 McGaw APG LLC,0,0,1,0,0,1
"2H Property 4101, LLC",0,0,1,0,0,1
3590 Peacock LLC,0,0,1,0,0,1
"601 South Ardmore, LP",0,0,1,0,0,1
640 Corporation,0,0,1,0,0,1
A-1 Oil Well Abandonment Co.,0,0,1,0,0,1
A & C Oil Co.,0,0,1,0,0,1
"A & K Oil Co., Inc.",0,0,1,0,0,1
A & M Oil & Gas Co.,0,0,1,0,0,1
A & M Pipeline Corp.,0,0,1,0,0,1
A & N Han LLC,0,0,1,0,0,1
A. & S. Petro. Corp.,0,0,1,0,0,1
A. & T. Syndicate,0,0,1,0,0,1
A. A. Carrey,0,0,1,0,0,1
A. A. Carrey-Oper.,0,0,1,0,0,1
"A. A. Mercola, Operator",0,0,1,0,0,1
A. A. Rollestone,0,0,1,0,0,1
A. B. Edler,0,0,1,0,0,1
A. B. Scott,0,0,1,0,0,1
A. C. Anderson,0,0,1,0,0,1
A. C. Fisher & J H Maurer,0,0,1,0,0,1
A. C. Platt,0,0,1,0,0,1
A. C. Skillington,0,0,1,0,0,1
A. C. Young,0,0,1,0,0,1
A. Chas Lantz,0,0,1,0,0,1
A. E. Dawson,0,0,1,0,0,1
A. F. Cahhoun,0,0,1,0,0,1
A. F. McCain,0,0,1,0,0,1
A. G. Frericks,0,0,1,0,0,1
A. G. Schwarz,0,0,1,0,0,1
A. Glassell Brown & Ethlyn Sidford Brown,0,0,1,0,0,1
A. H. & Lois Longest,0,0,1,0,0,1
A. H. Jamieson Oil Co.,0,0,1,0,0,1
A. H. Macfarland & Co.,0,0,1,0,0,1
"A. H. Masiran, et al",0,0,1,0,0,1
"A. I. M. Properties, Inc.",0,0,1,0,0,1
A. J. Borget,0,0,1,0,0,1
A. J. Brown,0,0,1,0,0,1
A. J. Crose,0,0,1,0,0,1
A. J. McGreevy,0,0,1,0,0,1
A. J. Mead,0,0,1,0,0,1
A. J. Rogers,0,0,1,0,0,1
"A. J. Rubenstein, M. Thomas Rynne, Wix Lichty, Hugo Duehr",0,0,1,0,0,1
"A. J. West, Hamilton & Sherman",0,0,1,0,0,1
A. L. & V. I. Grayson,0,0,1,0,0,1
A. L. Bergers,0,0,1,0,0,1
A. L. Frye,0,0,1,0,0,1
A. L. Jameson,0,0,1,0,0,1
A. L. Tull & L. Jay Waterbury,0,0,1,0,0,1
A. M. Gilstrap,0,0,1,0,0,1
A. M. Nahabedian & G D Fawcett,0,0,1,0,0,1
"A. M. Nahabedian, Operator",0,0,1,0,0,1
A. M. Van Flick,0,0,1,0,0,1
A. N. Brown & D. J. Pickrell,0,0,1,0,0,1
A. Nagayama & S. Haranaga,0,0,1,0,0,1
A. O. Margoles,0,0,1,0,0,1
A. Oberholtz,0,0,1,0,0,1
A. R. Johnson,0,0,1,0,0,1
A. T. Taecker,0,0,1,0,0,1
A. V. McIvor,0,0,1,0,0,1
"A. V. Oil & Gas Co., Inc.",0,0,1,0,0,1
A. W. Brooks,0,0,1,0,0,1
A. W. Lindberg & F. B. Donnelly,0,0,1,0,0,1
A. W. Schwarz,0,0,1,0,0,1
A.B.C. Syndicate,0,0,1,0,0,1
A.H. MacFarland,0,0,1,0,0,1
Abbott Petroleum Inc.,0,0,1,0,0,1
ABC Oil Co.,0,0,1,0,0,1
Abe Giesbrecht,0,0,1,0,0,1
Aberdeen American Petroleum Company Inc.,0,0,1,0,0,1
Ace Oil Company and Associates,0,0,1,0,0,1
Acme Drilling Co.,0,0,1,0,0,1
Acme Petrol Corp.Cal-Mex Oil & Ref. Co.,0,0,1,0,0,1
Acme Royalties Ltd.,0,0,1,0,0,1
"ACOP, Inc.",0,0,1,0,0,1
Acorn Drilling Co.,0,0,1,0,0,1
Acorn Oil Co.,0,0,1,0,0,1
Acorn Petro. Co.,0,0,1,0,0,1
"Acoya at Torrance, LLC",0,0,1,0,0,1
Acquila Oil & Mineral Co.,0,0,1,0,0,1
Action Oil and Dev. Co.,0,0,1,0,0,1
Adams & Moore,0,0,1,0,0,1
ADCO Ltd.,0,0,1,0,0,1
Adcris Crude Oil Co.,0,0,1,0,0,1
"Addison Oil & Gas, LLC",0,0,1,0,0,1
Adobe Hill Co.,0,0,1,0,0,1
Adrian Ansberry,0,0,1,0,0,1
Advance Petro. Ltd,0,0,1,0,0,1
Aeco Corp.& King Oil Inc.,0,0,1,0,0,1
Affiliated Oil Co.,0,0,1,0,0,1
Affiliated Oil Producers Inc.,0,0,1,0,0,1
Affiliated Petro. Corp.,0,0,1,0,0,1
Agey Petroleum Company,0,0,1,0,0,1
Air-O-Pac Research and Dev. Inc.,0,0,1,0,0,1
"Ajax Petro. Co., Ltd.",0,0,1,0,0,1
AL-Q-Oil Co.,0,0,1,0,0,1
Al Bresciani,0,0,1,0,0,1
Al Prisbrey,0,0,1,0,0,1
Alan W Rispin,0,0,1,0,0,1
Albert Angus,0,0,1,0,0,1
Albert Beck,0,0,1,0,0,1
Albert Crooks,0,0,1,0,0,1
Albert E. Peacock,0,0,1,0,0,1
Albert Petroleum Corp.,0,0,1,0,0,1
Albert W. Baxter,0,0,1,0,0,1
Alberta Oil Co.,0,0,1,0,0,1
Albertson-Boswell Oil Co.,0,0,1,0,0,1
Alcal Oil Co.,0,0,1,0,0,1
"Alex N. Campbell, Oper.",0,0,1,0,0,1
Alexander Drilling Co.,0,0,1,0,0,1
Alexander M Sandler,0,0,1,0,0,1
Alexander Valley Oil Co.,0,0,1,0,0,1
Alford Development Company,0,0,1,0,0,1
Alford Oil Company,0,0,1,0,0,1
Alfred P. Wolf,0,0,1,0,0,1
Alfred Tinally,0,0,1,0,0,1
Allan Ansdell Jr.,0,0,1,0,0,1
Alleghaney Petro. Corp.,0,0,1,0,0,1
Allen & Sheldon,0,0,1,0,0,1
Allen G Browne & Assoc.,0,0,1,0,0,1
Allen Petro. Co.,0,0,1,0,0,1
"Allied Properties, Inc.",0,0,1,0,0,1
Allison & Barlow,0,0,1,0,0,1
Allstates Petro. Corp.,0,0,1,0,0,1
Alma K. Larabee and A. Chas. Lantz,0,0,1,0,0,1
Almeria Industries Co.,0,0,1,0,0,1
Alpha Petro. Co.,0,0,1,0,0,1
"Alpine Oil Company, Ltd.",0,0,1,0,0,1
Alta Knolls Oil Company,0,0,1,0,0,1
Alta Loma Oil & Gas Co.,0,0,1,0,0,1
Alta Oil Corp.,0,0,1,0,0,1
"Altco Oil Co., Inc.",0,0,1,0,0,1
Alton Oil & Dev. Co.,0,0,1,0,0,1
"Alum Rock Oil Co., Ltd.",0,0,1,0,0,1
Alva McPhaill & Roy Gill,0,0,1,0,0,1
Alvera Petroleum Co.,0,0,1,0,0,1
Alvin M. Dunn,0,0,1,0,0,1
Amalgamated American Oil Inc.,0,0,1,0,0,1
Amalgamated Oil Co. of Nevada,0,0,1,0,0,1
Amanco Expl. Co.,0,0,1,0,0,1
Amapola Oil Corp.,0,0,1,0,0,1
America Drilling Co.,0,0,1,0,0,1
"Americal Exploration, Inc.",0,0,1,0,0,1
American Barter Petroleum Inc.,0,0,1,0,0,1
American Eagle Oil Co.,0,0,1,0,0,1
American Energy Corp.,0,0,1,0,0,1
American Exploration Co.,0,0,1,0,0,1
"American Minerals Mgmnt., Inc.",0,0,1,0,0,1
American Oil Corp.,0,0,1,0,0,1
"American Oil Developers, Ltd.",0,0,1,0,0,1
American Petroleum Corp.,0,0,1,0,0,1
American Quasar Petro. Co. of N.M.,0,0,1,0,0,1
American Quasar Petroleum of New Mexico,0,0,1,0,0,1
American Seamless Tube Corp.,0,0,1,0,0,1
Americo Oil Expl. & Drill. Co.,0,0,1,0,0,1
Ameroil Corp.,0,0,1,0,0,1
Ameroyal Energy Corp.,0,0,1,0,0,1
Amil A. Anderson,0,0,1,0,0,1
"Aminoil U.S.A., Inc.",0,0,1,0,0,1
Amron Oil Co.,0,0,1,0,0,1
Anaconda Petro. Co,0,0,1,0,0,1
Anchor Energy,0,0,1,0,0,1
Anderson-Prichard Oil Corp.,0,0,1,0,0,1
"Anderson, Giffen & Anderson",0,0,1,0,0,1
"Anderson, Lavering, Harriman & Piers",0,0,1,0,0,1
Andrew J. Crevolin,0,0,1,0,0,1
"Andrew J. St. Pierre, Jr.",0,0,1,0,0,1
Andrew Lucas,0,0,1,0,0,1
Andrews and Associates,0,0,1,0,0,1
Andrus and Hutcheson Inc.,0,0,1,0,0,1
Angel-Denny Corp.,0,0,1,0,0,1
Angeles Oil Corp.,0,0,1,0,0,1
Angelus Oil Co. Inc.,0,0,1,0,0,1
Angiola Oil Co.,0,0,1,0,0,1
Angle Oil Corp.,0,0,1,0,0,1
Anglo-American Oil Co.,0,0,1,0,0,1
Anglo American Petro. Inc.,0,0,1,0,0,1
Anglo Maricopa Oil Co.,0,0,1,0,0,1
Anna Baumgartner et al,0,0,1,0,0,1
Annie Fabian,0,0,1,0,0,1
Anson Syndicate,0,0,1,0,0,1
Antelope Oil Company,0,0,1,0,0,1
Antelope Plateau Oil Co.,0,0,1,0,0,1
"Antelope Valley Oil Co., Inc.",0,0,1,0,0,1
Antelope Valley Petro. Co.,0,0,1,0,0,1
Anthony-Rivers Dev. Co.,0,0,1,0,0,1
Anthony J. Keel,0,0,1,0,0,1
Anthony Oil,0,0,1,0,0,1
Antonio J. Cardozo,0,0,1,0,0,1
Apache Oil Co,0,0,1,0,0,1
Apex Dev. Corp.,0,0,1,0,0,1
Apex Drilling Co.,0,0,1,0,0,1
Applegate & Owens,0,0,1,0,0,1
APR Corporation,0,0,1,0,0,1
Arcady Oil Co. & San-Cal O & G,0,0,1,0,0,1
Archer Oil Co.,0,0,1,0,0,1
"Arden Oil Co., Ltd.",0,0,1,0,0,1
Argentena Consolidated Mining Co.,0,0,1,0,0,1
Argo Oil Co.,0,0,1,0,0,1
Argo Petro. Corp. & Aladdin Oil Corp.,0,0,1,0,0,1
Argonaut Energy Corp.,0,0,1,0,0,1
Argonaut Oil & Gas,0,0,1,0,0,1
Argyle Campbell & Co.,0,0,1,0,0,1
"Argyle M. Campbell, Egger & Rottman",0,0,1,0,0,1
Ariel Oil Co.,0,0,1,0,0,1
Ark Properties Inc.,0,0,1,0,0,1
Arkelo Petroleum Co.,0,0,1,0,0,1
Arleo Oil Co.,0,0,1,0,0,1
Arletta Community Association,0,0,1,0,0,1
"Arlington Properties Co., Ltd.",0,0,1,0,0,1
Armagh Oil Co.,0,0,1,0,0,1
Armstrong & Long,0,0,1,0,0,1
Armstrong Fowler Inc.,0,0,1,0,0,1
Aroostic Crude Oil Company,0,0,1,0,0,1
Arriba De La Estrella,0,0,1,0,0,1
Arrowhead Dev. Co.,0,0,1,0,0,1
Arrowhead Exploration Company,0,0,1,0,0,1
Arroyo Grande Pet Co. Inc.,0,0,1,0,0,1
Arthur Apple Petroleum,0,0,1,0,0,1
Arthur B. Clark and C. E. Huntoon,0,0,1,0,0,1
Arthur B. Ramsey,0,0,1,0,0,1
Arthur C. Fisher & J. H. Maurer,0,0,1,0,0,1
"Arthur C. Fisher, J. H. Maurer and Frank Barton",0,0,1,0,0,1
"Arthur C. Fisher, J. H. Maurer and J. D. Mullender",0,0,1,0,0,1
Arthur E. T. Chapman,0,0,1,0,0,1
Arthur F. Peterson and Associates,0,0,1,0,0,1
Arthur N. Macrate & Sons,0,0,1,0,0,1
"Arthur R. Studley, Jr.",0,0,1,0,0,1
Arthur W. Lyddon,0,0,1,0,0,1
Artnell Co. & Artnell O.& G.,0,0,1,0,0,1
Arvin-Kern Company,0,0,1,0,0,1
Ash Oil Syndicate,0,0,1,0,0,1
"Ashe Road Properties, L.P.",0,0,1,0,0,1
Ashley Dewitt,0,0,1,0,0,1
"Aslin Oil Co., Inc.",0,0,1,0,0,1
Asphalt Petro. Co. of Calif.,0,0,1,0,0,1
Associated Oil Co.,0,0,1,0,0,1
Associates Petro. Corp.,0,0,1,0,0,1
Assurance Oil Co.,0,0,1,0,0,1
"Atasca Resources, Inc.",0,0,1,0,0,1
Atha-Saris,0,0,1,0,0,1
Atherton Oil Co.,0,0,1,0,0,1
Atlanta Oil Company,0,0,1,0,0,1
Atlas Dev. Co.,0,0,1,0,0,1
Atlas Expl. Co.,0,0,1,0,0,1
Atlas Oil Co. & Harris Inv. Corp.,0,0,1,0,0,1
"Atlas Oil Company and Wm. R. Whittaker Co., Ltd.",0,0,1,0,0,1
Atlas Petroleum Co.,0,0,1,0,0,1
Atwood Oil Co.,0,0,1,0,0,1
"Ausbrit Oil Corp., Ltd.",0,0,1,0,0,1
Austin C. Sherman,0,0,1,0,0,1
"Austral Oil Co., Inc.",0,0,1,0,0,1
Avalon Petroleum Corp.,0,0,1,0,0,1
Aviation Oil Co.,0,0,1,0,0,1
Avila Oil Co.,0,0,1,0,0,1
Axem Resources Inc.,0,0,1,0,0,1
Aztec Drilling Corp.,0,0,1,0,0,1
B-K-S Oil Company,0,0,1,0,0,1
"B & G Caroline Apartments, LLC",0,0,1,0,0,1
B & G Oil Co.,0,0,1,0,0,1
B & L Drilling Co.,0,0,1,0,0,1
B & M Oil Co.,0,0,1,0,0,1
B & M Projects,0,0,1,0,0,1
B & O Service,0,0,1,0,0,1
B & R Oil Company,0,0,1,0,0,1
B and O Drilling and Exploration Company,0,0,1,0,0,1
B C R & F Oil & Gas Corp.,0,0,1,0,0,1
B G M Oil Co.,0,0,1,0,0,1
B M W Oil Co.,0,0,1,0,0,1
B. A. Gillespie,0,0,1,0,0,1
B. B. Holmes,0,0,1,0,0,1
B. C. & M. Oil Co.,0,0,1,0,0,1
B. D. & D. Co.,0,0,1,0,0,1
B. D. Whiteside,0,0,1,0,0,1
B. E. Gerner,0,0,1,0,0,1
B. E. Talley,0,0,1,0,0,1
B. F. Breig,0,0,1,0,0,1
"B. F. DeLanty and R. R. Sutton, Trustees",0,0,1,0,0,1
B. F. Peters & Associates,0,0,1,0,0,1
B. F. Porter Estate,0,0,1,0,0,1
B. H. Cochran,0,0,1,0,0,1
B. H. Sheldon Co.,0,0,1,0,0,1
B. K. Company,0,0,1,0,0,1
B. W. F. Oil Co.,0,0,1,0,0,1
B. W. Vinetz,0,0,1,0,0,1
B. Warren Vinetz,0,0,1,0,0,1
B.H.R. Oil & Gas Co.,0,0,1,0,0,1
Baash-Ross Tool Co.,0,0,1,0,0,1
Babak Kashani,0,0,1,0,0,1
Bacal Oil Co.,0,0,1,0,0,1
Badger Oil Co.,0,0,1,0,0,1
Bailey Balken,0,0,1,0,0,1
Baird Oil Co.,0,0,1,0,0,1
Bairstow Oil and Gas,0,0,1,0,0,1
Baker Oil,0,0,1,0,0,1
Bakersfield-Montebello Oil Co.,0,0,1,0,0,1
"Bakersfield Drilling Co., Inc.",0,0,1,0,0,1
Bald Eagle Oil Co.,0,0,1,0,0,1
Bald Mountain Drilling Co.,0,0,1,0,0,1
Ball & Gerner,0,0,1,0,0,1
Balscher Oil Co.,0,0,1,0,0,1
Bank of America,0,0,1,0,0,1
Bank of America NT & SA,0,0,1,0,0,1
Bankline Oil Company,0,0,1,0,0,1
"Banning, Fowler and Menveg",0,0,1,0,0,1
Barca Oil Co.,0,0,1,0,0,1
Barco Oil Co.,0,0,1,0,0,1
Barcoo Exploration Inc.,0,0,1,0,0,1
"Bardanal Engineering Co., Inc.",0,0,1,0,0,1
"Bargol Oil Co., Ltd.",0,0,1,0,0,1
"Barlinger, Corbridge & Gould",0,0,1,0,0,1
Barmesa Oil Co.,0,0,1,0,0,1
"Barmore, Spalding & McFann",0,0,1,0,0,1
Barneberg Oil Co.,0,0,1,0,0,1
Barnes & Shadrick,0,0,1,0,0,1
Barnes and Sandler Trustees,0,0,1,0,0,1
Barron Kidd Opr,0,0,1,0,0,1
"Barry Oil Co., Inc.",0,0,1,0,0,1
"Barth Oil Co., Inc.",0,0,1,0,0,1
Barto/Signal Petroleum,0,0,1,0,0,1
"Barton Enterprises, Inc.",0,0,1,0,0,1
Bauer Drilling Co.,0,0,1,0,0,1
"Baxter Petro. Co., Ltd.",0,0,1,0,0,1
Bay Shore Oil Co.,0,0,1,0,0,1
Bay View Oil Co.,0,0,1,0,0,1
Bayside Dev. Co.,0,0,1,0,0,1
Beach & Landini,0,0,1,0,0,1
Beacon Oil Corp.,0,0,1,0,0,1
Beadle-Torres,0,0,1,0,0,1
Beane Oil Co.,0,0,1,0,0,1
Bear Creek Oil & Mining,0,0,1,0,0,1
Bear River Gas Expl. Prog,0,0,1,0,0,1
Beard Brothers Oil & Gas,0,0,1,0,0,1
Beaudette-Dunn Petro. Co. Ltd.,0,0,1,0,0,1
Beaumont Expl. Co.,0,0,1,0,0,1
Beck Corp.,0,0,1,0,0,1
Beesum Oil Co.,0,0,1,0,0,1
Beetl Oil Co.,0,0,1,0,0,1
Bell Energy Corporation,0,0,1,0,0,1
Bell View Oil Syndicate,0,0,1,0,0,1
"Bellevue Resources, Inc.",0,0,1,0,0,1
Belmac Drilling Co.,0,0,1,0,0,1
Ben and Reuben Mooschekian and Associates,0,0,1,0,0,1
Ben D. Owens & M. A. Nishkian,0,0,1,0,0,1
Ben Heller,0,0,1,0,0,1
Ben Hur Refining Corp.,0,0,1,0,0,1
Ben R. Berman and Peter M. Rocovich,0,0,1,0,0,1
Bena Oil Co.,0,0,1,0,0,1
Benjamin Warren Vinetz,0,0,1,0,0,1
Bennett Expl. Co.,0,0,1,0,0,1
Bennett Petroleum Corp.,0,0,1,0,0,1
Benton Oil & Gas Company,0,0,1,0,0,1
Benwell Drilling Co.,0,0,1,0,0,1
Benwood Oil Co.,0,0,1,0,0,1
Bequette Oil Co.,0,0,1,0,0,1
"Berghofer, Lypps & LeMohn",0,0,1,0,0,1
Berkeley Oil Co.,0,0,1,0,0,1
Berken Oil Co.,0,0,1,0,0,1
Bernard J. Patton,0,0,1,0,0,1
Bernstein-Mathes Oil Co.,0,0,1,0,0,1
Berry-Loukonen Ltd.,0,0,1,0,0,1
Berry Petroleum Co.,0,0,1,0,0,1
Besco Oil Inc.,0,0,1,0,0,1
Bestco Petro. Corp.,0,0,1,0,0,1
Bestmi Petro. Corp.,0,0,1,0,0,1
Beth Petro. Corp.,0,0,1,0,0,1
Bettymac Oil Co.,0,0,1,0,0,1
"Beverly Trading & Exploration Co., and Bender Oil Operations",0,0,1,0,0,1
Bevo Drilling Co.,0,0,1,0,0,1
Bevo Oil Co.,0,0,1,0,0,1
Big 4 Oil Company,0,0,1,0,0,1
Big Bear Oil Co.,0,0,1,0,0,1
Big McKittrick Oil Co.,0,0,1,0,0,1
Big Tar Canyon Oil Co.,0,0,1,0,0,1
Biglo Co.,0,0,1,0,0,1
Bilgrad Oil Co.,0,0,1,0,0,1
Bill Tomberlin,0,0,1,0,0,1
Biltmore Oil Co.,0,0,1,0,0,1
Birch-Stoner,0,0,1,0,0,1
Birch Ranch Oil Co. et al,0,0,1,0,0,1
Bishop-Mt. Poso Oil Co.,0,0,1,0,0,1
Bishop and Associates,0,0,1,0,0,1
Bishop and Dolley Operators,0,0,1,0,0,1
"Bitterwater Oil, Inc.",0,0,1,0,0,1
Bixby Lease No. 1,0,0,1,0,0,1
"Bixby, Lawrence L.",0,0,1,0,0,1
Black Coral LLC,0,0,1,0,0,1
"Black Gold Petro. Co., Ltd.",0,0,1,0,0,1
Black Mountain Oil Co. (Pre 1977),0,0,1,0,0,1
Blackfoot-Cherokee Energy Inc.,0,0,1,0,0,1
"Blackfoot-Cherokee Energy, Inc.",0,0,1,0,0,1
Blackwood & Nichols Co,0,0,1,0,0,1
Blair Oil and Refinery Co.,0,0,1,0,0,1
"Blanton, Gendron & Cook",0,0,1,0,0,1
"Bloomfield Partners II, LLC",0,0,1,0,0,1
Blu-Cal Oil & Gas Corp.,0,0,1,0,0,1
Blue Bell Petro. Co.,0,0,1,0,0,1
Blue Opal Oil Co,0,0,1,0,0,1
"Blue Ridge Oil Co., Ltd.",0,0,1,0,0,1
Blue Ridge Petro. Co.,0,0,1,0,0,1
Blythe & Weatherwax,0,0,1,0,0,1
Bmw Co.,0,0,1,0,0,1
Bo-Peep Eureka Oil Co.,0,0,1,0,0,1
Boeco Drilling Co.,0,0,1,0,0,1
Bohemian Oil Co.,0,0,1,0,0,1
Bolling Oil Co.,0,0,1,0,0,1
Bolsa Chica Expl. Co.,0,0,1,0,0,1
Bolsa Chica Oil Corp. & Pacific Supply,0,0,1,0,0,1
Bomasp,0,0,1,0,0,1
Bonanza Oil Co.,0,0,1,0,0,1
Bond Dev. Corp.,0,0,1,0,0,1
Border Oil Company,0,0,1,0,0,1
Borst & Baker,0,0,1,0,0,1
Bostick Assoc.,0,0,1,0,0,1
Botfer Oil Co.,0,0,1,0,0,1
"Boulevard Oil Co., Ltd.",0,0,1,0,0,1
Bourke & Clark,0,0,1,0,0,1
Bourke & Dyer,0,0,1,0,0,1
"Bow Valley Petro., Inc.",0,0,1,0,0,1
Bowerbank Oil & Gas Co.,0,0,1,0,0,1
"Boyd Hammond, Trustee",0,0,1,0,0,1
Boyle Royalties Co.,0,0,1,0,0,1
Bradford & Gris,0,0,1,0,0,1
Bradley and Menveg,0,0,1,0,0,1
Bradley Canyon Oil Co.,0,0,1,0,0,1
"Bradley, Muhl & Johnson",0,0,1,0,0,1
"Bradley, Muhl And Associates",0,0,1,0,0,1
Bradshaw & Beville,0,0,1,0,0,1
"Brandenstein, Silverberry,et al",0,0,1,0,0,1
Breaoita Oil Co.,0,0,1,0,0,1
Breff Co.,0,0,1,0,0,1
Bremmor Petro. Corp.,0,0,1,0,0,1
Brennan Oil Co.,0,0,1,0,0,1
Breuer & Curran Oil Co,0,0,1,0,0,1
"Bright Dot Oil and Gas, LLC",0,0,1,0,0,1
Bright Oil Co.,0,0,1,0,0,1
Brighton Community Association,0,0,1,0,0,1
Briles Manufacturing,0,0,1,0,0,1
Brinkman Oil Co.,0,0,1,0,0,1
Bristol Oil Co.,0,0,1,0,0,1
Bristol Oil Corporation,0,0,1,0,0,1
Britannic Oil Corp.,0,0,1,0,0,1
British-American Investment Co.,0,0,1,0,0,1
"British-American, Inc.",0,0,1,0,0,1
Brittain-Terminal Oil Corp.,0,0,1,0,0,1
Britton Management Corp.,0,0,1,0,0,1
Brogdon Oil Company,0,0,1,0,0,1
Brokers Drilling Co.,0,0,1,0,0,1
Brookel Petro.,0,0,1,0,0,1
Brookner Oil Co.,0,0,1,0,0,1
Brooks & Bauerdorf,0,0,1,0,0,1
Brown,0,0,1,0,0,1
Brown & Dawson,0,0,1,0,0,1
Brown & Foster,0,0,1,0,0,1
Brown & Soults,0,0,1,0,0,1
Brown Drilling Co.,0,0,1,0,0,1
"Brown, Morgan Oil Corp.",0,0,1,0,0,1
Browngold Oil Co.,0,0,1,0,0,1
Brownson Drill Co. & Assoc,0,0,1,0,0,1
Bruce Oil Co.,0,0,1,0,0,1
Bruno T. Bisceglia,0,0,1,0,0,1
Bryan Smith,0,0,1,0,0,1
Buchner Bros.,0,0,1,0,0,1
"Bud Hildebrand, et al",0,0,1,0,0,1
Buell Ranch Oil Co.,0,0,1,0,0,1
Buena Vista Oil Co.,0,0,1,0,0,1
Buffalo Resources Corp.,0,0,1,0,0,1
Bunker Hill Co.,0,0,1,0,0,1
Bunting & Petrie,0,0,1,0,0,1
Burke A Thomas & L. Blake Baldwin,0,0,1,0,0,1
Burke A. Thomas,0,0,1,0,0,1
"Burney Acton & Henry D. Akin, Jr.",0,0,1,0,0,1
Burnham Expl. Co.,0,0,1,0,0,1
"Bush, Koff, & Lombard",0,0,1,0,0,1
Butler-Fetzer & Assoc,0,0,1,0,0,1
Butler & Associates,0,0,1,0,0,1
"Butte Petro. Co., Inc.",0,0,1,0,0,1
Buttonwillow Gas & Petroleum Co.,0,0,1,0,0,1
Byron H. Farwell,0,0,1,0,0,1
Byron Oil Well Dev. Co.,0,0,1,0,0,1
C-M Oil Co.,0,0,1,0,0,1
C-M Syndicate,0,0,1,0,0,1
C & C Expl. Co.,0,0,1,0,0,1
C & C Minerals Ltd,0,0,1,0,0,1
C & K Oil Co.,0,0,1,0,0,1
C & L Resources c/o V. Chesser,0,0,1,0,0,1
C & M Dev. Co.,0,0,1,0,0,1
C & P Oil Co.,0,0,1,0,0,1
C & S Oil Co.,0,0,1,0,0,1
"C & T Transportation Co., Oper.",0,0,1,0,0,1
C & V Expl. Co.,0,0,1,0,0,1
C Tut Lee Oper.,0,0,1,0,0,1
C. & M. Oil Co.,0,0,1,0,0,1
C. & N. Oil Corp.,0,0,1,0,0,1
"C. A. Fear, Inc.",0,0,1,0,0,1
C. A. Fickle and Doyle Wattenbarger,0,0,1,0,0,1
"C. A. Fickle, Operator",0,0,1,0,0,1
C. A. Julian and D. W. Criswell,0,0,1,0,0,1
C. A. Maino et al,0,0,1,0,0,1
"C. A. Paimer, Trustee",0,0,1,0,0,1
C. A. Pearson & R M Steffen,0,0,1,0,0,1
C. A. Petrie Drilling Co.,0,0,1,0,0,1
C. A. Stone,0,0,1,0,0,1
C. A. Welsh,0,0,1,0,0,1
C. B. Barnes,0,0,1,0,0,1
C. B. Callahan,0,0,1,0,0,1
C. B. Douglas,0,0,1,0,0,1
C. B. Douglas & Mary Douglas,0,0,1,0,0,1
C. C. Hale,0,0,1,0,0,1
C. C. Hamilton,0,0,1,0,0,1
"C. C. Harris, Trustee",0,0,1,0,0,1
C. C. Peterson,0,0,1,0,0,1
C. C. White,0,0,1,0,0,1
C. D. Cunningham & Transcal Drilling Co.,0,0,1,0,0,1
C. D. S. Oil Co.,0,0,1,0,0,1
C. E. Beatty and C. M. Morse,0,0,1,0,0,1
C. E. Beatty and Horace Steele,0,0,1,0,0,1
C. E. Brain,0,0,1,0,0,1
C. E. Braly,0,0,1,0,0,1
C. E. Doheny et al,0,0,1,0,0,1
C. E. Pettingall,0,0,1,0,0,1
C. Earl Stoner,0,0,1,0,0,1
"C. F. Green, Oper.",0,0,1,0,0,1
C. F. Grundy,0,0,1,0,0,1
"C. F. McCarthy, et al",0,0,1,0,0,1
C. Frederic Wehr,0,0,1,0,0,1
C. H. Bent,0,0,1,0,0,1
C. H. Finley,0,0,1,0,0,1
"C. H. S. Co., Ltd.",0,0,1,0,0,1
C. J. Berry,0,0,1,0,0,1
C. J. Gardner and John R. Powell,0,0,1,0,0,1
C. J. Gibson and L. A. Delaney,0,0,1,0,0,1
C. J. Howell,0,0,1,0,0,1
C. L. Fowler & Assoc.,0,0,1,0,0,1
C. L. Fowler & Son,0,0,1,0,0,1
C. L. Hussey,0,0,1,0,0,1
C. L. Reese,0,0,1,0,0,1
C. Lee Mueller,0,0,1,0,0,1
"C. M. Crawford, Jr.",0,0,1,0,0,1
C. M. Morse,0,0,1,0,0,1
C. M. Rood,0,0,1,0,0,1
C. O. & L. M. Rodabaugh,0,0,1,0,0,1
C. O. Brand,0,0,1,0,0,1
C. P. Phelps,0,0,1,0,0,1
C. P. Watson,0,0,1,0,0,1
C. R. Butler,0,0,1,0,0,1
C. R. Edgecomb-Trustee,0,0,1,0,0,1
C. R. Hannaman & Assoc.,0,0,1,0,0,1
C. R. McCollom & W. H. Taylor,0,0,1,0,0,1
C. R. Miller,0,0,1,0,0,1
C. R. Miller & W. E. Nicolai,0,0,1,0,0,1
C. S. & H. Oil Co.,0,0,1,0,0,1
C. S. Jones,0,0,1,0,0,1
C. Stephens,0,0,1,0,0,1
C. T. Dougherty & D. Lindeman,0,0,1,0,0,1
C. V. Wreden,0,0,1,0,0,1
C. W. Bloemer,0,0,1,0,0,1
C. W. Ellsworth,0,0,1,0,0,1
C. W. Farmer,0,0,1,0,0,1
C. W. Ginter & Assoc.,0,0,1,0,0,1
C. W. Griffin,0,0,1,0,0,1
C. W. Wright,0,0,1,0,0,1
CA-SP No. 1,0,0,1,0,0,1
Cabot Corp.,0,0,1,0,0,1
Cache Oil Co.,0,0,1,0,0,1
Cady Oil Co,0,0,1,0,0,1
Caithness Corporation,0,0,1,0,0,1
Cajalco Petroleum Co.,0,0,1,0,0,1
Cajon Basin Co.,0,0,1,0,0,1
Cal-Bay Corp.,0,0,1,0,0,1
Cal-O-Tex Expl. Co.,0,0,1,0,0,1
Cal-Oil Trust,0,0,1,0,0,1
Cal-Pico Oil Co.,0,0,1,0,0,1
Cal-Tex Tungsten Co.,0,0,1,0,0,1
Cal-Ute Development Co.,0,0,1,0,0,1
"Cal Continental Capital, Inc.",0,0,1,0,0,1
Cal Nevada Oil Co.,0,0,1,0,0,1
Cal Pride Farms,0,0,1,0,0,1
Cal. Counties,0,0,1,0,0,1
Cala-Cruz Oil Corp.,0,0,1,0,0,1
Calawaii Oil Co.,0,0,1,0,0,1
Calcoast Oil Co.,0,0,1,0,0,1
"Caldrill, Inc.",0,0,1,0,0,1
Calfield Oil Corp.,0,0,1,0,0,1
Calhoma Oil Corp.,0,0,1,0,0,1
Calif Land & Cattle Co.,0,0,1,0,0,1
Calif Southern Oil Co.,0,0,1,0,0,1
Calif Valley Oil Co.,0,0,1,0,0,1
Calif. Oil Lands,0,0,1,0,0,1
Calif. Republic Petro. Corp.,0,0,1,0,0,1
California-Maine Oil Co.,0,0,1,0,0,1
California Coast Oil Co.,0,0,1,0,0,1
California Consolidated Oil Corp.,0,0,1,0,0,1
California Counties Oil Co.,0,0,1,0,0,1
California Crude Oil Co.,0,0,1,0,0,1
"California Energy Co., Inc.",0,0,1,0,0,1
California Machinery & Supply Co.,0,0,1,0,0,1
California Medal Products Co.,0,0,1,0,0,1
California National Supply Co.,0,0,1,0,0,1
California Northern Corp.,0,0,1,0,0,1
California Oil Fields Corp. Ltd.,0,0,1,0,0,1
"California Oil Producers, Inc.",0,0,1,0,0,1
California Oils Inc.,0,0,1,0,0,1
California Petro. Corp.,0,0,1,0,0,1
California Profit Sharing Co.,0,0,1,0,0,1
California Reliance,0,0,1,0,0,1
California Resorts,0,0,1,0,0,1
California Resorts/Haseko Assoc.,0,0,1,0,0,1
California Southern Crude Oil,0,0,1,0,0,1
California Tar Sands Development Corp.,0,0,1,0,0,1
Califrill Oil Co.,0,0,1,0,0,1
Calistoga,0,0,1,0,0,1
Calizoo Oil Co.,0,0,1,0,0,1
Calleguas Oil Syndicate,0,0,1,0,0,1
Callie M. Higgins,0,0,1,0,0,1
Calmont Oil Co.,0,0,1,0,0,1
Calnev Investment Corp.,0,0,1,0,0,1
Caloil Producing Company,0,0,1,0,0,1
Calstan Petroleum Co.,0,0,1,0,0,1
Caltana Corp.,0,0,1,0,0,1
Calwin Oil Co.,0,0,1,0,0,1
Camarillo Oil Co.,0,0,1,0,0,1
Camarillo Oil Synd,0,0,1,0,0,1
Camden Exploration Co.,0,0,1,0,0,1
Camden Oil Co.,0,0,1,0,0,1
Camerina Petro. Corp.,0,0,1,0,0,1
Cameron Wright,0,0,1,0,0,1
"Camp Oil Co., Inc.",0,0,1,0,0,1
Campbell & Associates,0,0,1,0,0,1
Campbell and Shell,0,0,1,0,0,1
"Campbell, Shell & Collins",0,0,1,0,0,1
Campeet Oil Co.,0,0,1,0,0,1
Camroo Oil Co.,0,0,1,0,0,1
Canada West Oil Co.,0,0,1,0,0,1
Canadian Capital Corp.,0,0,1,0,0,1
Cannella & Cannella,0,0,1,0,0,1
Cannon Day Oil Synd.,0,0,1,0,0,1
Cantua Creek Oil Co.,0,0,1,0,0,1
Canus Petroleum Inc.,0,0,1,0,0,1
"Cap Drilling Co., Inc.",0,0,1,0,0,1
Cape Co.,0,0,1,0,0,1
Captain Richard Thew,0,0,1,0,0,1
Caravel Petroleum Corp.,0,0,1,0,0,1
"Carbon Oil Co., Ltd.",0,0,1,0,0,1
Carey-Evans Oil Co.,0,0,1,0,0,1
Caribou Oil Mining Co.,0,0,1,0,0,1
Carl Crossen,0,0,1,0,0,1
Carl E. Braly,0,0,1,0,0,1
Carl E. Kreyenhagen,0,0,1,0,0,1
"Carl Pressel, Frank Perry & Gilbert Tull",0,0,1,0,0,1
Carl R. Pohland Assoc.,0,0,1,0,0,1
Carl S. Weller,0,0,1,0,0,1
Carla Stafford-Lewis,0,0,1,0,0,1
Carlisle Oil Co,0,0,1,0,0,1
Carlton Beal,0,0,1,0,0,1
Carmack Oil Co.,0,0,1,0,0,1
Carolina Oil Co.,0,0,1,0,0,1
Carolina Western Oil Company,0,0,1,0,0,1
Carpenteria Oil,0,0,1,0,0,1
Carpinteria Oil & Gas Co.,0,0,1,0,0,1
"Carr, Wrath & Payne",0,0,1,0,0,1
Carranza Oil Co.,0,0,1,0,0,1
Carrey & Adams,0,0,1,0,0,1
Carrey & Edwards,0,0,1,0,0,1
Carrillo Expl. Co.,0,0,1,0,0,1
Carrizo Valley Oil Corp.,0,0,1,0,0,1
"Carter Petro. Co., Ltd.",0,0,1,0,0,1
Carter Purvis,0,0,1,0,0,1
"Carter, Evans and Assoc",0,0,1,0,0,1
Casa Grande Oil Co.,0,0,1,0,0,1
Casamera Oil Co.,0,0,1,0,0,1
Case Min. & Pet.,0,0,1,0,0,1
Casner and Bentz,0,0,1,0,0,1
Castaic Oil Association,0,0,1,0,0,1
Castaic Oil Company,0,0,1,0,0,1
Castle Oil Co.,0,0,1,0,0,1
Castro Expl Co.,0,0,1,0,0,1
Castro Oil Co.,0,0,1,0,0,1
Cat Canyon Oil Co.,0,0,1,0,0,1
Cates Allen No. 1,0,0,1,0,0,1
"Cather, Rogers, Barnes & Cree",0,0,1,0,0,1
"Cather, Rowan and Barnes & Co.",0,0,1,0,0,1
Cavalier Petro. Corp.,0,0,1,0,0,1
"CDB Investments, L.P.",0,0,1,0,0,1
Cecelia Petro. Co.,0,0,1,0,0,1
Cecille M. Colvin,0,0,1,0,0,1
Cedar Oil Co.,0,0,1,0,0,1
"Celito Oil Corp., Ltd.",0,0,1,0,0,1
Centinela Oil Co.,0,0,1,0,0,1
Central Cal. Oil Co. of Vallejo,0,0,1,0,0,1
Central Natural Gas Co.,0,0,1,0,0,1
Central Oil Co. of L.A.,0,0,1,0,0,1
Central Petro. Co.,0,0,1,0,0,1
Central Union,0,0,1,0,0,1
Central Valley Petro Co.,0,0,1,0,0,1
Centura Inc.,0,0,1,0,0,1
"Century Exploration Resources, LLC",0,0,1,0,0,1
Chadwick G. Trower-Patricia P. Trower,0,0,1,0,0,1
"Challenger Minerals, Inc.",0,0,1,0,0,1
Chalmas & Ford,0,0,1,0,0,1
Channel Oils Ltd,0,0,1,0,0,1
Charles A. Cole,0,0,1,0,0,1
Charles A. Son,0,0,1,0,0,1
Charles B. Colby,0,0,1,0,0,1
Charles B. Webster,0,0,1,0,0,1
"Charles Bailey, Trustee",0,0,1,0,0,1
Charles Beyerbach,0,0,1,0,0,1
Charles Black,0,0,1,0,0,1
Charles F. Simonds Trustee,0,0,1,0,0,1
"Charles H. Hornburg, Jr.",0,0,1,0,0,1
Charles Hayes Kreigh,0,0,1,0,0,1
Charles R. Blyth,0,0,1,0,0,1
"Charles R. Jacobsen, Ltd.",0,0,1,0,0,1
"Charles R. Jacobson, Operator",0,0,1,0,0,1
Charles R. Tatum & Sons,0,0,1,0,0,1
Charles S. & Marie E. Geers,0,0,1,0,0,1
Charles S. Cressaty,0,0,1,0,0,1
Charles W. Camp,0,0,1,0,0,1
Charles W. Harlow,0,0,1,0,0,1
Charles W. Hinesley,0,0,1,0,0,1
Charlton Resources Corp.,0,0,1,0,0,1
Chas E. McCartney,0,0,1,0,0,1
Chas Schmitz,0,0,1,0,0,1
Chas. A. Son,0,0,1,0,0,1
Chas. Differding Trustee,0,0,1,0,0,1
Chas. H. Kaar,0,0,1,0,0,1
Chase Exploration Co.,0,0,1,0,0,1
Chathill Syndicate,0,0,1,0,0,1
Chauk Oil Co.,0,0,1,0,0,1
Chemical Oil Co.,0,0,1,0,0,1
Cherokee Oil Co.,0,0,1,0,0,1
Cherry Hill Co.,0,0,1,0,0,1
Cherry Hill Oil & Gas Co.,0,0,1,0,0,1
Cherrydale Oil Co.,0,0,1,0,0,1
Cheseborough & Goldner,0,0,1,0,0,1
Chester J. Knight,0,0,1,0,0,1
Chicago Oil Co.,0,0,1,0,0,1
Chief Oil Company,0,0,1,0,0,1
Chieftan Oil Co. & Chieftan-Larsen Bros.,0,0,1,0,0,1
Chillicothe Oil & Mining Co.,0,0,1,0,0,1
Chillmani Oil Co.,0,0,1,0,0,1
Chimineas Ltd,0,0,1,0,0,1
Chino-Corono United Oil Co.,0,0,1,0,0,1
Chino Expl. Co.,0,0,1,0,0,1
Chino Lease Co.,0,0,1,0,0,1
CHOB Oil Co.,0,0,1,0,0,1
Cholame Syndicate,0,0,1,0,0,1
"Chris Kufis, M.L. Mitchell, E.A. Frits",0,0,1,0,0,1
Chris Pedersen & J. P. Lahorgue,0,0,1,0,0,1
Chris Pedersen & Raymond Fife,0,0,1,0,0,1
Christian Petersen,0,0,1,0,0,1
Church & Bell Beach,0,0,1,0,0,1
Cimarron Petro. Co.,0,0,1,0,0,1
"Cinco Development Co., Inc",0,0,1,0,0,1
Cinco Inc.,0,0,1,0,0,1
Cirque Resources LP,0,0,1,0,0,1
Cities Service Oil & Gas Corporation,0,0,1,0,0,1
Cities Service Oil Co. & Atlantic Oil Co,0,0,1,0,0,1
Citizens Oil Corp. of California,0,0,1,0,0,1
Citrus Grove Hts. Water Co.,0,0,1,0,0,1
City of Hermosa Beach,0,0,1,0,0,1
City of Torrance,0,0,1,0,0,1
Clair J Gibson,0,0,1,0,0,1
Clar-Kel Oil Co.,0,0,1,0,0,1
Claran Oil Co,0,0,1,0,0,1
Claremont Energy,0,0,1,0,0,1
Clarence Decker and W. T. Osborne,0,0,1,0,0,1
Clarence E. Harrison,0,0,1,0,0,1
Clarence M. Turner Syndicate,0,0,1,0,0,1
Clarion Res. Inc.,0,0,1,0,0,1
Clark Oil Co.,0,0,1,0,0,1
Clark Stevens & Duncan,0,0,1,0,0,1
Claud Clayton,0,0,1,0,0,1
Claude Kavanaugh & L R Wilhite,0,0,1,0,0,1
Clayton Devl Co.,0,0,1,0,0,1
Clear View Oil Co.,0,0,1,0,0,1
Cliff Baker,0,0,1,0,0,1
Cliff E. Zillgitt & James H. McCue,0,0,1,0,0,1
Cliff Petroleum,0,0,1,0,0,1
Clifford A. Robinett,0,0,1,0,0,1
Clifford H. Johnson,0,0,1,0,0,1
"Clifford H. Marker, Operator",0,0,1,0,0,1
Clifford I. Miller,0,0,1,0,0,1
Climax Oil Co.,0,0,1,0,0,1
Clint H. Woodington,0,0,1,0,0,1
Clovis Oil Co.,0,0,1,0,0,1
Club Oil Co.,0,0,1,0,0,1
Clyde F. Taylor,0,0,1,0,0,1
Clyde Oil Company,0,0,1,0,0,1
Co-Operative Oil Corp.,0,0,1,0,0,1
Co-Operative Petro. Synd. No.3,0,0,1,0,0,1
Coalinga-Mohawk Oil Co.,0,0,1,0,0,1
Coalinga Hub Oil Co.,0,0,1,0,0,1
Coalinga Income Oil Co.,0,0,1,0,0,1
Coalinga Kettleman Oil Co.,0,0,1,0,0,1
Coalinga Lubricating Oil Co.,0,0,1,0,0,1
Coalinga Red Top,0,0,1,0,0,1
Coalinga South Pole,0,0,1,0,0,1
Coast-Gibson Oil Operations,0,0,1,0,0,1
"Coast-Parker, Inc.",0,0,1,0,0,1
Coast Expl. & Golden Bear Oil Co.,0,0,1,0,0,1
Coast Oil Co.,0,0,1,0,0,1
Coast Supply Co.,0,0,1,0,0,1
Coastal Energy Dev. Co.,0,0,1,0,0,1
Coastal Oil Co.,0,0,1,0,0,1
"Coastline Oil Co., Ltd",0,0,1,0,0,1
Coastridge Oil Co.,0,0,1,0,0,1
Cobra Oil Co.,0,0,1,0,0,1
"Cochran Oil Co., Inc.",0,0,1,0,0,1
Coelho & Case Oil Company,0,0,1,0,0,1
Coffman Oil Co. Ltd,0,0,1,0,0,1
Cohearn Oil Co.,0,0,1,0,0,1
Cohn & Mitchell,0,0,1,0,0,1
Cole Oil Co.,0,0,1,0,0,1
"Cole, Drais, Martter and Wood, Inc.",0,0,1,0,0,1
"Coleman L. Caine, Oper.",0,0,1,0,0,1
"College West Partners, LP",0,0,1,0,0,1
Colma Oil Co.,0,0,1,0,0,1
Colonial Oil Corp.,0,0,1,0,0,1
Colorado Oil Company,0,0,1,0,0,1
Colquitt Drilling Co.,0,0,1,0,0,1
Columbia Pacific Petro. Corp.,0,0,1,0,0,1
Columbus Midway Oil Co.,0,0,1,0,0,1
Colvin and Delaney,0,0,1,0,0,1
Comanche Point Oil,0,0,1,0,0,1
Comanche Point Production Co. Inc.,0,0,1,0,0,1
Combined Oil Co.,0,0,1,0,0,1
COMCO,0,0,1,0,0,1
Commander Oil Company,0,0,1,0,0,1
Commercial Oil Co. of California,0,0,1,0,0,1
"Commercial Oil Corp., Ltd.",0,0,1,0,0,1
Commodore Petroleum Corporation,0,0,1,0,0,1
Community Oil,0,0,1,0,0,1
Como Oil Co.,0,0,1,0,0,1
Compass Oil Co.,0,0,1,0,0,1
Comstock Crude,0,0,1,0,0,1
Comstock Oil Co.,0,0,1,0,0,1
Comstock Petro. Co.,0,0,1,0,0,1
Conejo Hills Oil Co.,0,0,1,0,0,1
Conejo Oil Trust,0,0,1,0,0,1
Conexx Oil Company Inc.,0,0,1,0,0,1
Confidence Oil Co.,0,0,1,0,0,1
Conrad A. Fischer,0,0,1,0,0,1
"Considine Oil Co., Ltd.",0,0,1,0,0,1
Consolidated Empire Petro. Inc.,0,0,1,0,0,1
Consolidated Oil Co.,0,0,1,0,0,1
"Consolidated Properties, Ltd.",0,0,1,0,0,1
Constance V. L. Perry,0,0,1,0,0,1
Constitutional Oil Co.,0,0,1,0,0,1
Continental Development Corporation,0,0,1,0,0,1
"Continental Properties, Inc.",0,0,1,0,0,1
Contra Costa Oil Synd,0,0,1,0,0,1
Contratto Oil Co.,0,0,1,0,0,1
Cook Westrn Oil & Gas Prod Inc,0,0,1,0,0,1
"Cooperative Dev. Co., Ltd.",0,0,1,0,0,1
Copa De Ora Petro. Co.,0,0,1,0,0,1
Coral Hoyt,0,0,1,0,0,1
Cordelia Oil & Gas Co.,0,0,1,0,0,1
Core Drill Ltd,0,0,1,0,0,1
Core Oil Syndicate,0,0,1,0,0,1
Corey,0,0,1,0,0,1
Corinth Petro. Corp.,0,0,1,0,0,1
Corlitz Oil Co.,0,0,1,0,0,1
Cormac Drilling & Prod.,0,0,1,0,0,1
Cornell & Givan,0,0,1,0,0,1
Coronado Oil Co.,0,0,1,0,0,1
Corrigan Oil Co.,0,0,1,0,0,1
Coseka Resources (USA) Ltd.,0,0,1,0,0,1
Cosmo Oil Co.,0,0,1,0,0,1
Costa Mesa County Water District,0,0,1,0,0,1
Costa Mesa Oil Co.,0,0,1,0,0,1
"Costajo Ranch, Inc.",0,0,1,0,0,1
Country Club Oil Co.,0,0,1,0,0,1
Cousins Oil Co.,0,0,1,0,0,1
"Covington Oil Co., Ltd.",0,0,1,0,0,1
Cox & Alexander,0,0,1,0,0,1
"Coyote Oil, LLC",0,0,1,0,0,1
Craft Petro. Corp.,0,0,1,0,0,1
Crafton Oil Co.,0,0,1,0,0,1
Craig-Burns & Co. Inc.,0,0,1,0,0,1
Craig & Winn Oil Co.,0,0,1,0,0,1
Craig H. Lewis,0,0,1,0,0,1
Crail Bros Inc. Ltd,0,0,1,0,0,1
Crawford & Assoc.,0,0,1,0,0,1
Crawford H. Bent,0,0,1,0,0,1
Crawford Hiles,0,0,1,0,0,1
Cree Oil Company,0,0,1,0,0,1
Cree Oil Ltd - Barco Oil Co.,0,0,1,0,0,1
Crescent Petroleum Co.,0,0,1,0,0,1
Crest Petro. Co.,0,0,1,0,0,1
Crestmont Oil Company,0,0,1,0,0,1
Crestmount Oil Co.,0,0,1,0,0,1
Creston Operator LLC,0,0,1,0,0,1
Crissman & Watkins,0,0,1,0,0,1
Crome Oil Co.,0,0,1,0,0,1
Crosno and Elliston,0,0,1,0,0,1
Crown-Huntington Oils Ltd.--Vagabond,0,0,1,0,0,1
Crown & Cree Oil Co.,0,0,1,0,0,1
Crown & Stevenson,0,0,1,0,0,1
Crown Energy Dev. Co.,0,0,1,0,0,1
Crown King Oil Co.,0,0,1,0,0,1
"Crude Oil Drilling Co., Ltd.",0,0,1,0,0,1
"Crude Oil Producers, Inc.",0,0,1,0,0,1
"Crude Oils, Inc.",0,0,1,0,0,1
Crupper Operating & Trading Company,0,0,1,0,0,1
Crusaders Petroleum Corp.,0,0,1,0,0,1
Crystal Oil Co.,0,0,1,0,0,1
Cullen E. Nye,0,0,1,0,0,1
"Culver Investments, Inc.",0,0,1,0,0,1
Cumberland Oil Co.,0,0,1,0,0,1
"Cumming Petroleum, Ltd.",0,0,1,0,0,1
"Cunningham Investments, Inc.",0,0,1,0,0,1
"Currency Petro., Inc.",0,0,1,0,0,1
Cuyama Petro. Co.,0,0,1,0,0,1
Cuyama Trust Syndicate,0,0,1,0,0,1
Cuyama Valley Oil Corp.Lt,0,0,1,0,0,1
"Cyrus Peirce, Agent",0,0,1,0,0,1
Czoco Oil Company,0,0,1,0,0,1
D'Angelo Oil Co.,0,0,1,0,0,1
D & B Oil Co.,0,0,1,0,0,1
D H M Oil Co.,0,0,1,0,0,1
D K Associates - 2,0,0,1,0,0,1
D K Associates #3,0,0,1,0,0,1
D. & M. Oil Co.,0,0,1,0,0,1
D. A. Brown,0,0,1,0,0,1
"D. A. Rogers, Oper.",0,0,1,0,0,1
D. A. Stark,0,0,1,0,0,1
D. D. Dunlap & E. A. Bender,0,0,1,0,0,1
D. D. Feldman,0,0,1,0,0,1
D. D. Lucas,0,0,1,0,0,1
D. E. Brannan,0,0,1,0,0,1
D. G. MacGregor,0,0,1,0,0,1
D. H. B. Oil Co.,0,0,1,0,0,1
D. H. Graham & Assoc. Well No. 2,0,0,1,0,0,1
D. H. Graham & Assoc. Well No. 3,0,0,1,0,0,1
"D. H. Graham, Operator",0,0,1,0,0,1
D. Herbert Hostetter,0,0,1,0,0,1
D. J. Pickrell & E. W. Meyer,0,0,1,0,0,1
D. K. Partnership #3,0,0,1,0,0,1
D. K. Partnership #4,0,0,1,0,0,1
D. M. & Associates,0,0,1,0,0,1
D. M. Gay,0,0,1,0,0,1
D. R. Langstaff,0,0,1,0,0,1
D. S. & W. Oil Co.,0,0,1,0,0,1
D. S. Bushnell,0,0,1,0,0,1
D. Tresaden & H Reynolds,0,0,1,0,0,1
D. V. Nelson,0,0,1,0,0,1
D. W. Elliot & Assoc.,0,0,1,0,0,1
D. W. Elliott and Pexco Inc.,0,0,1,0,0,1
D. W. Griffith Oil Co.,0,0,1,0,0,1
"D.G.H. Developers, Inc.",0,0,1,0,0,1
D.R.K. Co.,0,0,1,0,0,1
Dabney & Lloyd,0,0,1,0,0,1
Dabney & Robertson,0,0,1,0,0,1
Dacarr Corp.,0,0,1,0,0,1
Dafor Dev. Co.,0,0,1,0,0,1
Daigle Enterprises,0,0,1,0,0,1
Dale Hankins,0,0,1,0,0,1
"Dale, I J Vojvoda & Assoc",0,0,1,0,0,1
Dallas D. Cox,0,0,1,0,0,1
Dan Fisher Opr,0,0,1,0,0,1
Dan Murphy,0,0,1,0,0,1
Dan Sheppard,0,0,1,0,0,1
Dan Sheppard & Assoc.,0,0,1,0,0,1
Danciger Oil & Refinin Co.,0,0,1,0,0,1
Daniel M Hunsaker & Geo C Atha,0,0,1,0,0,1
Daniele Amfitheatrof and Associates,0,0,1,0,0,1
Danielson Oil Co.,0,0,1,0,0,1
Darby Oil Co. of Nevada,0,0,1,0,0,1
David C Jones & Richard Jones,0,0,1,0,0,1
David D. Behr,0,0,1,0,0,1
David E. Hedgecock,0,0,1,0,0,1
David Fiddyment,0,0,1,0,0,1
David Robbins,0,0,1,0,0,1
David W. Silvers,0,0,1,0,0,1
Davidge & Wilson,0,0,1,0,0,1
Davidson Oil Co.,0,0,1,0,0,1
Davis & Haines,0,0,1,0,0,1
Davis & Irwin,0,0,1,0,0,1
Davis & MacMillan Co.,0,0,1,0,0,1
Davis & Remington,0,0,1,0,0,1
"Davis, Davis & Davis",0,0,1,0,0,1
Dawson Oil Co.,0,0,1,0,0,1
DBF Partners,0,0,1,0,0,1
De Anza Oil Co. Ltd.,0,0,1,0,0,1
De Leske Petro. Corp.,0,0,1,0,0,1
Deane Newenham,0,0,1,0,0,1
Deep Hole Drilling Corp.,0,0,1,0,0,1
Deep Zone Oil Co.,0,0,1,0,0,1
"Deertrail Abbey Court 1, LLC",0,0,1,0,0,1
"Deeter Homes, Inc.",0,0,1,0,0,1
Degener Petroleum Corporation,0,0,1,0,0,1
Del Amo-Earl Properties,0,0,1,0,0,1
"Del Amo Associates, LLC",0,0,1,0,0,1
Del Amo Energy Co.,0,0,1,0,0,1
Del Mar Oil Corp.,0,0,1,0,0,1
Del Valle Gasoline Co.,0,0,1,0,0,1
Delaney Producing & Refining Co.,0,0,1,0,0,1
Delay Land Co.,0,0,1,0,0,1
Delfern Joint Venture,0,0,1,0,0,1
Delroco Oil,0,0,1,0,0,1
Delroy Petro. Corp.,0,0,1,0,0,1
"Delta Mgm Corp., Fitzgerald, Oper.",0,0,1,0,0,1
Delta Sierra Oil & Gas LLC,0,0,1,0,0,1
"Den Petroleum, Inc.",0,0,1,0,0,1
Dennis & Palmer,0,0,1,0,0,1
"Denny Drilling Co., Ltd.",0,0,1,0,0,1
"Denverton Gas Co., Ltd.",0,0,1,0,0,1
Department of Water Res.,0,0,1,0,0,1
Department of Water Resources (DWR),0,0,1,0,0,1
Derby Oil & Gas Co.,0,0,1,0,0,1
Derby Oil of Calif. Inc.,0,0,1,0,0,1
Desert Glow Oil Company,0,0,1,0,0,1
Devils Den Consolidated Oil Co.,0,0,1,0,0,1
"Devine and Bell, Oper.",0,0,1,0,0,1
Dewayne L. Boccali,0,0,1,0,0,1
Dewitt Langford,0,0,1,0,0,1
Diablo Oil Co.,0,0,1,0,0,1
Diamond Drilling Company,0,0,1,0,0,1
"Dicco, Inc.",0,0,1,0,0,1
Dill & Comstock,0,0,1,0,0,1
Dispatch Oil,0,0,1,0,0,1
District Oil Co.,0,0,1,0,0,1
"DLM Ventures, LLC",0,0,1,0,0,1
Doc Expl. Co.,0,0,1,0,0,1
Doc Oil Co. of Nevada,0,0,1,0,0,1
Dodson Oil Co.,0,0,1,0,0,1
Doheny Stone Drill Co.,0,0,1,0,0,1
Dohm Oil Co.,0,0,1,0,0,1
"Dollar Oil Co., Inc.",0,0,1,0,0,1
Dollar Oil Company,0,0,1,0,0,1
Dome Oil Co.,0,0,1,0,0,1
Dominguez Estate Co.,0,0,1,0,0,1
Dominguez Oil Co.,0,0,1,0,0,1
"Don A. and Jean Robinson Irrevocable Trust, Dated May 8th, 1997",0,0,1,0,0,1
Don A. Leigh,0,0,1,0,0,1
"Don C. Winkler, Operator",0,0,1,0,0,1
Don Galitzen,0,0,1,0,0,1
Don J. Leeman,0,0,1,0,0,1
Don Le,0,0,1,0,0,1
Don Pedro Oil Co.,0,0,1,0,0,1
Don Smith and Assoc.,0,0,1,0,0,1
Donald & Alice Santos,0,0,1,0,0,1
Donald B. Lamont,0,0,1,0,0,1
"Donald C. Slawson Expl.Co.,Inc.",0,0,1,0,0,1
Donald Frankel,0,0,1,0,0,1
Donald Kendall and Assoc.,0,0,1,0,0,1
Donald Len Barreth,0,0,1,0,0,1
Donald M. Smith,0,0,1,0,0,1
Donald S. Alexander,0,0,1,0,0,1
Donald S. Redington,0,0,1,0,0,1
Donald W. Whittier,0,0,1,0,0,1
Donco Co.,0,0,1,0,0,1
Donhill Petro. Co.,0,0,1,0,0,1
Donnelly Production Co.,0,0,1,0,0,1
Dorothy E. Leingang,0,0,1,0,0,1
Dougan Drilling Co,0,0,1,0,0,1
Douglas-Stratton Oil Co.,0,0,1,0,0,1
Douglas Drilling Company,0,0,1,0,0,1
Douglas H Graham,0,0,1,0,0,1
"Douglas H. Graham, Oper.",0,0,1,0,0,1
Douglas Marcell,0,0,1,0,0,1
"Douglas Marcell, Oper.",0,0,1,0,0,1
"Douglas W. Baker, Trustee",0,0,1,0,0,1
Douglas Whitney,0,0,1,0,0,1
Dover Fiduciary Corp.,0,0,1,0,0,1
Down East Co.,0,0,1,0,0,1
Downey Land Co.,0,0,1,0,0,1
Downey Oil Corp.,0,0,1,0,0,1
Downs-Fleming,0,0,1,0,0,1
Dowser Exploration Venture,0,0,1,0,0,1
Doyle-Clune Oil Co.,0,0,1,0,0,1
Doyle D. Barnes,0,0,1,0,0,1
Dr. E. Lowell Schaefer,0,0,1,0,0,1
Dr. Edwin Larson,0,0,1,0,0,1
Dr. F. A. Speik,0,0,1,0,0,1
Dr. John B. Davis,0,0,1,0,0,1
Dr. Lamb,0,0,1,0,0,1
Dr. R. W. Hill,0,0,1,0,0,1
Dragon Oil Co.,0,0,1,0,0,1
Drake Supply Co.,0,0,1,0,0,1
Dralock Oil Co.,0,0,1,0,0,1
"Dresco, Inc.",0,0,1,0,0,1
"Drillers, Inc.",0,0,1,0,0,1
Dual Petroleum Corp.,0,0,1,0,0,1
Ducor Oil Co.,0,0,1,0,0,1
Ducor Petroleum Company,0,0,1,0,0,1
"Dudley-Kettleman Gas & Oil Co., Ltd.",0,0,1,0,0,1
"Dudley Ridge Oil Co., Ltd.",0,0,1,0,0,1
Dugan Oil Co.,0,0,1,0,0,1
"Dugite Resources, Inc.",0,0,1,0,0,1
Duke Oil Corp.,0,0,1,0,0,1
"Duke Realty La Palma Oil Well Abandonment, LLC",0,0,1,0,0,1
Dun Mar Oil Co.,0,0,1,0,0,1
Dunlap-Apex & Assoc.,0,0,1,0,0,1
Dunlap and Bell,0,0,1,0,0,1
Duquesne Oil Co.,0,0,1,0,0,1
Durango Oil Co.,0,0,1,0,0,1
Durgin Allen & Cosby,0,0,1,0,0,1
"Dusty Mac Resources, Inc.",0,0,1,0,0,1
Dutch Oil Co.,0,0,1,0,0,1
Dwight G. Vedder Co.,0,0,1,0,0,1
Dyak Expl Co. Ltd,0,0,1,0,0,1
Dyer Creek Oil Co.,0,0,1,0,0,1
"Dyna-World Investments, Inc.",0,0,1,0,0,1
Dynamic Builders Inc.,0,0,1,0,0,1
"E-T Marina, A Calif. Ltd. Part",0,0,1,0,0,1
E. A. Beaudette,0,0,1,0,0,1
E. A. Bender and Burton Benwell,0,0,1,0,0,1
E. A. Bender and D. D. Dunlap,0,0,1,0,0,1
E. A. Bender Drilling Co.,0,0,1,0,0,1
"E. A. Bender, et al",0,0,1,0,0,1
E. A. Fennell Co. Inc.,0,0,1,0,0,1
E. A. Hall,0,0,1,0,0,1
E. A. Parkford's Signal Hill Oil Synd. 1,0,0,1,0,0,1
E. A. Parkford-Bolsa Chica Oil,0,0,1,0,0,1
E. A. Parkford & Assoc.,0,0,1,0,0,1
E. and S. Oil Co.,0,0,1,0,0,1
E. B. Brooks Jr.,0,0,1,0,0,1
E. B. Campbell,0,0,1,0,0,1
E. B. Gormley,0,0,1,0,0,1
E. B. Kinney,0,0,1,0,0,1
E. C. Arnold Oil Company,0,0,1,0,0,1
E. C. Green,0,0,1,0,0,1
E. C. Johnson,0,0,1,0,0,1
E. C. Reid,0,0,1,0,0,1
E. C. Von Glahn & G Leingan,0,0,1,0,0,1
E. C. Von Glahn & P H Frank,0,0,1,0,0,1
E. D. Irons,0,0,1,0,0,1
E. D. Killingsworth and Noel C. Parker,0,0,1,0,0,1
E. D. Pauley & H.R. Pauley,0,0,1,0,0,1
E. D. Robertson,0,0,1,0,0,1
"E. D. Sweet, J. M. Kroninger & Roussel",0,0,1,0,0,1
E. D. Taylor Co.,0,0,1,0,0,1
E. E. Carpenter,0,0,1,0,0,1
E. E. Combs,0,0,1,0,0,1
"E. E. Combs, Fox M. Boswell, et al",0,0,1,0,0,1
"E. E. Easton, Trustee",0,0,1,0,0,1
E. E. Jennings,0,0,1,0,0,1
E. E. Mahannah,0,0,1,0,0,1
E. E. Millican,0,0,1,0,0,1
"E. E. Pyles, Oper.",0,0,1,0,0,1
E. F. Britton,0,0,1,0,0,1
E. F. Stella,0,0,1,0,0,1
E. G. Burke,0,0,1,0,0,1
E. G. Erickson,0,0,1,0,0,1
E. G. Erickson & C.K. Swanson,0,0,1,0,0,1
E. H. A. Andrews,0,0,1,0,0,1
E. H. Brawner,0,0,1,0,0,1
E. H. Brogdon,0,0,1,0,0,1
E. H. Jones and H. R. Pauley,0,0,1,0,0,1
E. H. Loose & J. Dietzmann,0,0,1,0,0,1
E. H. Lovelady & Page Frambes,0,0,1,0,0,1
E. H. Mitchell,0,0,1,0,0,1
E. I. du Pont de Nemours & Co. Inc.,0,0,1,0,0,1
E. J. Burns,0,0,1,0,0,1
E. J. Fife & R E Fife Sr,0,0,1,0,0,1
E. J. Harp and Geo. L. Tilton,0,0,1,0,0,1
E. J. Kasey and Associates,0,0,1,0,0,1
E. J. Woodward,0,0,1,0,0,1
E. Jorgensen,0,0,1,0,0,1
E. K. Allison Syndicate,0,0,1,0,0,1
E. K. Potter,0,0,1,0,0,1
E. L. Blanck,0,0,1,0,0,1
E. L. Cord,0,0,1,0,0,1
E. L. Corwin,0,0,1,0,0,1
E. L. Doheny & E L Doheny.,0,0,1,0,0,1
E. L. Labadie,0,0,1,0,0,1
E. L. Olmstead Oil Co.,0,0,1,0,0,1
E. L. Tompkins,0,0,1,0,0,1
E. M. Bedford,0,0,1,0,0,1
E. M. Breem,0,0,1,0,0,1
E. M. Richardson and J. W. Heaston,0,0,1,0,0,1
E. M. Shannon,0,0,1,0,0,1
E. M. Spaulding,0,0,1,0,0,1
"E. M. Tilbury & F.E. Weagant, Op",0,0,1,0,0,1
E. O. Reid,0,0,1,0,0,1
E. Randolph Smith,0,0,1,0,0,1
E. Recknagel H. W. Mangold & Wm Wagoner,0,0,1,0,0,1
"E. T. Willard, Trustee",0,0,1,0,0,1
E. W. Lenhart,0,0,1,0,0,1
E. W. Spiers,0,0,1,0,0,1
E.K.S. Oil Co.,0,0,1,0,0,1
Eagle Oil & Varnish Co.,0,0,1,0,0,1
Eagle Petroleum Consultants,0,0,1,0,0,1
Earl Costello,0,0,1,0,0,1
Earl Kelly,0,0,1,0,0,1
Earl Petro. Corp. Ltd.,0,0,1,0,0,1
Earl V. Rhoads & Reuben C. Gilliam,0,0,1,0,0,1
Earle Moore,0,0,1,0,0,1
Earth Basics Contracting Corp.,0,0,1,0,0,1
EAS & Assoc.,0,0,1,0,0,1
Eason Oil Co.,0,0,1,0,0,1
Eason Oil Company,0,0,1,0,0,1
East Beach Oil Co.,0,0,1,0,0,1
East Coalinga Oilfields Corp.,0,0,1,0,0,1
East Elwood Petro. Corp.,0,0,1,0,0,1
East Piru Oil Co.,0,0,1,0,0,1
East San Emidio Oil Land Co.,0,0,1,0,0,1
East Standard Corporation,0,0,1,0,0,1
East Trico Oil Company,0,0,1,0,0,1
"Easterday Exploration, Inc.",0,0,1,0,0,1
Eastern Natural Gas Corp.,0,0,1,0,0,1
Eastern Oil Co.,0,0,1,0,0,1
Easton-Monell,0,0,1,0,0,1
Ebert and Brandt,0,0,1,0,0,1
Ebert E. Smith,0,0,1,0,0,1
Ebert Oil Co.,0,0,1,0,0,1
"Ebert, Hendricks & Hendricks",0,0,1,0,0,1
ECC Oil Company,0,0,1,0,0,1
Echo-Brea Oil Co.,0,0,1,0,0,1
Ecology Auto Wrecking,0,0,1,0,0,1
Ed McAdams,0,0,1,0,0,1
"Ed McAdams, Trustee",0,0,1,0,0,1
Eddie Lebaron,0,0,1,0,0,1
Eddy & Riedman,0,0,1,0,0,1
Eddystone Oil Corp.,0,0,1,0,0,1
Edgemont Petro. Co.,0,0,1,0,0,1
Edison Securities Co.,0,0,1,0,0,1
Edna M. Allenbaugh,0,0,1,0,0,1
Edw. A. Kelly,0,0,1,0,0,1
"Edward B. Towne, Jr.",0,0,1,0,0,1
Edward G. Cummings,0,0,1,0,0,1
Edward Gieck,0,0,1,0,0,1
Edward Hennes,0,0,1,0,0,1
Edward Kline,0,0,1,0,0,1
Edward M Lang,0,0,1,0,0,1
Edward M. Lesperance,0,0,1,0,0,1
"Edward M. Tilbury, Operator",0,0,1,0,0,1
Edward Pietzschke,0,0,1,0,0,1
Edward R. Richter,0,0,1,0,0,1
Edward S. McAuliffe,0,0,1,0,0,1
Edwards & Cole,0,0,1,0,0,1
Edwin A. McKanna,0,0,1,0,0,1
"Edwin W. Pauley, Oper.",0,0,1,0,0,1
Eel River Expl. Co.,0,0,1,0,0,1
EHA Andrews,0,0,1,0,0,1
El Cam Oil Co.,0,0,1,0,0,1
El Camino Oil Co. Ltd,0,0,1,0,0,1
El Cerrito Oil Co.,0,0,1,0,0,1
"El Hondo Petro., Inc.",0,0,1,0,0,1
El Jemaro Oil Co.,0,0,1,0,0,1
El Rancho Expl. Co.,0,0,1,0,0,1
El Rika Oil Co.,0,0,1,0,0,1
El Segundo Oil Corp.,0,0,1,0,0,1
Elba Oil Co.,0,0,1,0,0,1
Eldee Oil Co.,0,0,1,0,0,1
Electro-Cap Inc.,0,0,1,0,0,1
Electrological Petro. Corp.,0,0,1,0,0,1
Eleda Oil Co.,0,0,1,0,0,1
Eliot M. Ashe,0,0,1,0,0,1
"Elisha Walker, Jr.",0,0,1,0,0,1
Elizabeth B. Guiberson,0,0,1,0,0,1
Elizabeth E. Heyler and David B. Heyler,0,0,1,0,0,1
Elizalde Oil Co.,0,0,1,0,0,1
Elk Expl. Inc.,0,0,1,0,0,1
Elk Hills Petroleum Corporation,0,0,1,0,0,1
Elk Slough Pipeline Co.,0,0,1,0,0,1
Elkhorn Oil and Development Co.,0,0,1,0,0,1
Elkhorn Petro. Co.,0,0,1,0,0,1
Ella Chisholm Dorn,0,0,1,0,0,1
"Ella M, Krouskop, H. G. Triplett & Roof",0,0,1,0,0,1
"Elliott-Herley-Marshall, Partnership",0,0,1,0,0,1
Elliott & Classen,0,0,1,0,0,1
Elliott Classen & Mickle,0,0,1,0,0,1
Elliott Core Drilling Company,0,0,1,0,0,1
"Elliott Roosevelt, Jr.",0,0,1,0,0,1
Elmer C. Von Glahn Assoc.,0,0,1,0,0,1
"Elmer J. Boeseke, Jr.",0,0,1,0,0,1
Elmer Knotts & Associates,0,0,1,0,0,1
Elmer L. Knotts,0,0,1,0,0,1
"Elmo Knight, Operator",0,0,1,0,0,1
Elmo W. Adams,0,0,1,0,0,1
Em. H. Mettler & Sons,0,0,1,0,0,1
Emerald San Joaquin Corp.,0,0,1,0,0,1
Emerell Expl Co.,0,0,1,0,0,1
Emigrant Hill Oil Company,0,0,1,0,0,1
Emil & Ruby Plegel,0,0,1,0,0,1
Emjayco,0,0,1,0,0,1
Emma F. Exline,0,0,1,0,0,1
Emmons & Emmons,0,0,1,0,0,1
Encinal Oil Co.,0,0,1,0,0,1
Engine Oil & Gas Corp.,0,0,1,0,0,1
"Engineering, Drilling & Production, Inc.",0,0,1,0,0,1
Enron Oil & Gas Company,0,0,1,0,0,1
Ensign United States Drilling (CA) Inc.,0,0,1,0,0,1
Epco Inc.,0,0,1,0,0,1
Epsilon Oil and Gas Co.,0,0,1,0,0,1
Equality Oil Co.,0,0,1,0,0,1
Equitable Petro. Expl. Co.,0,0,1,0,0,1
Era Oil Co.,0,0,1,0,0,1
Ermine Keystone LLC,0,0,1,0,0,1
Ernest C. Matthews,0,0,1,0,0,1
Ernest Edwards and K. Edwards,0,0,1,0,0,1
Ernest F. Lang,0,0,1,0,0,1
Ernest Meyer,0,0,1,0,0,1
Ernest R. Smith,0,0,1,0,0,1
Ernie Combs,0,0,1,0,0,1
"Esparto-Lincoln Oil Fields, Inc.",0,0,1,0,0,1
Esperanza Consolidated Oil Co.,0,0,1,0,0,1
Esperanza Oil Co.,0,0,1,0,0,1
Essex Oil & Gas Company,0,0,1,0,0,1
Estate of A. A. Rembold,0,0,1,0,0,1
Estate of A. H. & R. M. Kiesau,0,0,1,0,0,1
Estate of Albert Stevenson,0,0,1,0,0,1
Estate of E. B. Hougham Op.,0,0,1,0,0,1
Estate of Edward A. Beaudette,0,0,1,0,0,1
Estate of Elizabeth A. Bixler,0,0,1,0,0,1
"Estate of Etienne Lang, Deceased",0,0,1,0,0,1
Estate of George W. Smith,0,0,1,0,0,1
"Estate of Hampton & Co., Inc. Bankrupt",0,0,1,0,0,1
Estate of J Stephen Horn,0,0,1,0,0,1
Estate of J. E. O'Donnell,0,0,1,0,0,1
Estate of J. J. Baker,0,0,1,0,0,1
Estate of John K. Kesson,0,0,1,0,0,1
Estate of Otis Birch,0,0,1,0,0,1
Estate of Raymond D. Herzog,0,0,1,0,0,1
Estate of Warren L. Meeker & R. Garner,0,0,1,0,0,1
Estate of Wayne Mills,0,0,1,0,0,1
Estrella Partnership,0,0,1,0,0,1
Eugen Kronisch,0,0,1,0,0,1
Eugene C. McClaran,0,0,1,0,0,1
Eugene E. Marble,0,0,1,0,0,1
Eureka Canyon Syndicate,0,0,1,0,0,1
Eureka Co.,0,0,1,0,0,1
Evans-Carter,0,0,1,0,0,1
"Evans-Jacobson Expl. Co., Ltd.",0,0,1,0,0,1
Everett H. Jones,0,0,1,0,0,1
Everett Oil Company,0,0,1,0,0,1
Evinger Brothers,0,0,1,0,0,1
Excelsior Oil Co.,0,0,1,0,0,1
"Exergy Oil Company, LLC",0,0,1,0,0,1
Exline Fisher & Quist,0,0,1,0,0,1
"F-W Oil Interests, Inc.",0,0,1,0,0,1
F. & W. Petroleum Company,0,0,1,0,0,1
F. A. Black,0,0,1,0,0,1
F. A. Craise,0,0,1,0,0,1
F. A. McDonald,0,0,1,0,0,1
F. A. Miller & R R Nance,0,0,1,0,0,1
F. A. Nighbert,0,0,1,0,0,1
"F. A. Rose Oil & Royalty Co., Inc.",0,0,1,0,0,1
F. B. Langstroth,0,0,1,0,0,1
F. C. Goetz,0,0,1,0,0,1
F. D. Goody,0,0,1,0,0,1
"F. E. Borton, James Petrini, G. E. Gilmore Jr. and Sam Ashe",0,0,1,0,0,1
F. E. Ellis,0,0,1,0,0,1
F. E. Null & R. V. Hearons,0,0,1,0,0,1
F. F. Partridge,0,0,1,0,0,1
F. G. Anderson,0,0,1,0,0,1
F. G. Anderson Trustee,0,0,1,0,0,1
F. G. Butler,0,0,1,0,0,1
F. G. Phillips & Co.,0,0,1,0,0,1
F. G. Walker,0,0,1,0,0,1
F. H. Prather & Assoc.,0,0,1,0,0,1
F. J. Cooper,0,0,1,0,0,1
F. Kenney,0,0,1,0,0,1
F. M. Hewlett,0,0,1,0,0,1
F. M. Pottenger,0,0,1,0,0,1
F. McAteer and W. R. Wells,0,0,1,0,0,1
F. O. Wood,0,0,1,0,0,1
F. R. Shaffer and Karl Lehndorfer,0,0,1,0,0,1
F. S. D. Oil Co.,0,0,1,0,0,1
F. S. Simpson,0,0,1,0,0,1
F. W. McNear,0,0,1,0,0,1
F. W. Tutin & H H Twisselman,0,0,1,0,0,1
F. W. W. Drilling Co.,0,0,1,0,0,1
"F.H.R. Oil Co., Ltd.",0,0,1,0,0,1
Fairhaven Oil Co. Inc.,0,0,1,0,0,1
Fairmount Expl. Co.,0,0,1,0,0,1
Falcon Seaboard Drilling Co.,0,0,1,0,0,1
Fallis Oil Co.,0,0,1,0,0,1
Falma Oil Co.,0,0,1,0,0,1
Family Oil Co.,0,0,1,0,0,1
Famosa Oil Co.,0,0,1,0,0,1
Fannie L. Griffith et al,0,0,1,0,0,1
Farmlands Int. Energy Co.,0,0,1,0,0,1
Fate Oil Co,0,0,1,0,0,1
Fay Wright - Operator,0,0,1,0,0,1
Federal Cons. Oil Co.,0,0,1,0,0,1
"Federal Exploration Co., Inc.",0,0,1,0,0,1
FeLyBy Associates LLC,0,0,1,0,0,1
Ferdon & Vurpillat Oil Land Synd.,0,0,1,0,0,1
Fernando Oil Co.,0,0,1,0,0,1
Ferraro Construction Co.,0,0,1,0,0,1
"Fidelity Realty Corp., Ltd.",0,0,1,0,0,1
Field Energy Corp.,0,0,1,0,0,1
Fifty-Seven Oil Co.,0,0,1,0,0,1
Fillmore Improvement,0,0,1,0,0,1
Fillmore Land Co.,0,0,1,0,0,1
Fillmore Oil & Refining Co.,0,0,1,0,0,1
"Filmland Oil Co., Ltd.",0,0,1,0,0,1
Filon Expl. Corp.,0,0,1,0,0,1
Fire-Rice Drilling Co.,0,0,1,0,0,1
Firedart Oil Co.,0,0,1,0,0,1
"Firmin Court, L.P.",0,0,1,0,0,1
Fischgrund and Shane,0,0,1,0,0,1
Fishcer Oil Co.,0,0,1,0,0,1
Fisher-Gregg Oil Syndicate,0,0,1,0,0,1
"Fisher Lease, Inc.",0,0,1,0,0,1
Fiske & Curtis,0,0,1,0,0,1
Five Points Petroleum Corp.,0,0,1,0,0,1
"Five Star Drive-In Theater, Inc.",0,0,1,0,0,1
Flagstaff Oil Co.,0,0,1,0,0,1
Flamingo Oil Co.,0,0,1,0,0,1
Fleet Expl Ltd,0,0,1,0,0,1
Fleet Petro. Co.,0,0,1,0,0,1
Fleetwood Oil Co.,0,0,1,0,0,1
Fletcher Dart,0,0,1,0,0,1
Florence M. Brauer,0,0,1,0,0,1
Florida Expl. Co.,0,0,1,0,0,1
Floyd & Alene Jenner,0,0,1,0,0,1
Floyd Day,0,0,1,0,0,1
Floyd S. Herring,0,0,1,0,0,1
Flying J Oil & Gas Inc.,0,0,1,0,0,1
FMR Services Inc.,0,0,1,0,0,1
"Ford Alexander, et al",0,0,1,0,0,1
"Forestar Chatsworth, LLC",0,0,1,0,0,1
"Forexco, Inc.",0,0,1,0,0,1
Forrest R. Majors,0,0,1,0,0,1
Fort Wayne-Madera Syndicate,0,0,1,0,0,1
Foster-Maxam Corp.,0,0,1,0,0,1
Fountain Springs Oil Company,0,0,1,0,0,1
Foust and Roath,0,0,1,0,0,1
Fowler-Hull & Co.,0,0,1,0,0,1
Fowler and Oles Oil Co.,0,0,1,0,0,1
Fowler Drilling Co.,0,0,1,0,0,1
"Fowler Drilling Co. & Stansbury, Inc.",0,0,1,0,0,1
"Fowler, Boone and Assoc.",0,0,1,0,0,1
"Fowler, Satchell & Co.",0,0,1,0,0,1
"Fox M. Boswell, et al",0,0,1,0,0,1
Foxen Oil Co.,0,0,1,0,0,1
Frakes Oil Co.,0,0,1,0,0,1
Francis O'Reilly,0,0,1,0,0,1
Francis S. Markiewicz & Patricia Markiewicz,0,0,1,0,0,1
Frank A. McDonald,0,0,1,0,0,1
Frank C. Cann,0,0,1,0,0,1
Frank C. Creasey,0,0,1,0,0,1
"Frank Collins, Trustee",0,0,1,0,0,1
"Frank E. Abbott, Trustee",0,0,1,0,0,1
"Frank Goldman and Howard H. Bell, Jr.",0,0,1,0,0,1
Frank Hall and J. F. Early,0,0,1,0,0,1
Frank M. Anderson,0,0,1,0,0,1
Frank M. Gilstrap,0,0,1,0,0,1
"Frank M. Taylor, Oper.",0,0,1,0,0,1
Frank Marik,0,0,1,0,0,1
"Frank McKay, Oper.",0,0,1,0,0,1
Frank Messina,0,0,1,0,0,1
Frank P. Sproul,0,0,1,0,0,1
Frank R. Halterman,0,0,1,0,0,1
Frank S. Wallace,0,0,1,0,0,1
Frank Shannon,0,0,1,0,0,1
Frank Waters Oil Co.,0,0,1,0,0,1
Frankel Orloff Oil Co.,0,0,1,0,0,1
"Frankley-Harriman, Inc.",0,0,1,0,0,1
Franklin Oil Co. of Calif.,0,0,1,0,0,1
Franru Oil Co.,0,0,1,0,0,1
Frans Nelson and Company,0,0,1,0,0,1
Frantzen Petroleum Corp.,0,0,1,0,0,1
Franzke & E.W. King,0,0,1,0,0,1
Fraser & Paulsen,0,0,1,0,0,1
Frazier-Finley,0,0,1,0,0,1
"Fred-Lite Blocks, Inc.",0,0,1,0,0,1
Fred A. Kochergen,0,0,1,0,0,1
Fred A. McMaster and Carolyn C. McMaster,0,0,1,0,0,1
Fred A. Miller & Associates,0,0,1,0,0,1
Fred Allen,0,0,1,0,0,1
Fred Arkenburg,0,0,1,0,0,1
Fred B. Copeland,0,0,1,0,0,1
Fred Bauchwitz,0,0,1,0,0,1
Fred Bever & Fred Lippert,0,0,1,0,0,1
Fred C. Herman,0,0,1,0,0,1
Fred C. Macomber,0,0,1,0,0,1
Fred D. McMillen,0,0,1,0,0,1
Fred E. Stewart,0,0,1,0,0,1
"Fred F. Faber, Jr.",0,0,1,0,0,1
Fred Fitch,0,0,1,0,0,1
Fred G. Delaney,0,0,1,0,0,1
Fred G. Walker & Albert Monyier,0,0,1,0,0,1
Fred Goodstein,0,0,1,0,0,1
Fred J. Elliott,0,0,1,0,0,1
"Fred Jasper, Jr.",0,0,1,0,0,1
"Fred M. Manning, Inc.",0,0,1,0,0,1
Fred N. Gholson,0,0,1,0,0,1
Fred R. Williams,0,0,1,0,0,1
Fred T. Moody,0,0,1,0,0,1
Fred Thompson,0,0,1,0,0,1
Fred Thompson and Stephens Oil Co.,0,0,1,0,0,1
Fred W. Moser and George C. Atha,0,0,1,0,0,1
Frederick A. Speik,0,0,1,0,0,1
Frederick C. Beyl,0,0,1,0,0,1
Frederick Libby,0,0,1,0,0,1
Frederick Oil Corp.,0,0,1,0,0,1
Freedom Drilling Co.,0,0,1,0,0,1
Freedom General Repair & Pump Shop,0,0,1,0,0,1
Freeman E. Gates,0,0,1,0,0,1
Freeman Oil,0,0,1,0,0,1
"Freeman Oil & Gas Co., Inc.",0,0,1,0,0,1
"Frende W. Combs, Agent",0,0,1,0,0,1
Fresno-San Benito Oil Co.,0,0,1,0,0,1
Fresno Associated Oil & Gas Co.,0,0,1,0,0,1
Fresno Drilling Co.,0,0,1,0,0,1
Fresno Petro. Co.,0,0,1,0,0,1
Fresno Sunmaid Oil Co.,0,0,1,0,0,1
Fugler Ranch Oil,0,0,1,0,0,1
Fulkerson Oil Co.,0,0,1,0,0,1
Fundamental Oil Corp.,0,0,1,0,0,1
Funk and Loomis,0,0,1,0,0,1
Future Success Oil Co.,0,0,1,0,0,1
G & J Corp.,0,0,1,0,0,1
G & S Expl. Co.,0,0,1,0,0,1
G & W Drilling Co.,0,0,1,0,0,1
G C Thompson,0,0,1,0,0,1
G. A. Grober & Associates,0,0,1,0,0,1
G. A. Langstaff,0,0,1,0,0,1
G. B. Cavalletto,0,0,1,0,0,1
G. B. Finch,0,0,1,0,0,1
G. B. Finch Oil Co.,0,0,1,0,0,1
G. C. Nelson,0,0,1,0,0,1
G. D. Murdoch,0,0,1,0,0,1
G. E. Hutchinson & Assoc.,0,0,1,0,0,1
G. E. McKinney & Wayne H. Myers,0,0,1,0,0,1
G. E. Renner & R.H.L. Oil Co.,0,0,1,0,0,1
G. Everett Miller,0,0,1,0,0,1
G. H. D. Oil Co.,0,0,1,0,0,1
G. Hamilton Beasley,0,0,1,0,0,1
G. J. Green,0,0,1,0,0,1
"G. J. Green, Merle W. Wheeler and Alex Walton",0,0,1,0,0,1
G. J. Landers,0,0,1,0,0,1
G. Kinkaid,0,0,1,0,0,1
G. L. Bergman,0,0,1,0,0,1
G. M. Knapp,0,0,1,0,0,1
G. N. Bray,0,0,1,0,0,1
G. W. Chort,0,0,1,0,0,1
G.E.M.E.S. & Fowler Oil Co.,0,0,1,0,0,1
G.L. Speir Co.,0,0,1,0,0,1
Gabilan Oil Co.,0,0,1,0,0,1
Gaddie Dev. Co.,0,0,1,0,0,1
Galen B. Finch & Assoc.,0,0,1,0,0,1
Galveston Oil Co.,0,0,1,0,0,1
Gammon & Gammon,0,0,1,0,0,1
Gannon and Winel,0,0,1,0,0,1
"Ganong & Ellison, Operator",0,0,1,0,0,1
Gantry Corp.,0,0,1,0,0,1
Gardena Royalties Co.,0,0,1,0,0,1
Garliepp & Assoc.,0,0,1,0,0,1
Garner-Price,0,0,1,0,0,1
Garner Bros. Oil Co.,0,0,1,0,0,1
Garten Expl Co.,0,0,1,0,0,1
Garten Exploration Co. & M. O. Garten,0,0,1,0,0,1
Gary-Williams Oil,0,0,1,0,0,1
Gary Wells,0,0,1,0,0,1
Gas Oil Leasing Development Co.,0,0,1,0,0,1
Gaston A. Bastanchury,0,0,1,0,0,1
"Gate King Properties, LLC",0,0,1,0,0,1
Gates Oil Co.,0,0,1,0,0,1
Gato Ridge Oil,0,0,1,0,0,1
Gatos Creek Oil Co.,0,0,1,0,0,1
Gaviota Oil Co,0,0,1,0,0,1
"GDM Resources, Inc.",0,0,1,0,0,1
GEH,0,0,1,0,0,1
Gene Reid Oil Co.,0,0,1,0,0,1
Gene W. East,0,0,1,0,0,1
General American Oil Co. of Texas,0,0,1,0,0,1
General Oil Co.,0,0,1,0,0,1
General Prod. Corp. of Arizona,0,0,1,0,0,1
Geneva Marie Co.,0,0,1,0,0,1
"Geo-Logic, Inc.",0,0,1,0,0,1
Geo A Taylor & Ben Rankin,0,0,1,0,0,1
Geo G Parry,0,0,1,0,0,1
Geo W. Johnsonny,0,0,1,0,0,1
Geo. A. McDonald,0,0,1,0,0,1
Geo. A. Parsons,0,0,1,0,0,1
Geo. Capron,0,0,1,0,0,1
Geo. F. Wilson & N.B. Rairden,0,0,1,0,0,1
Geo. Goodrum,0,0,1,0,0,1
"Geo. Goodrum, Ltd.",0,0,1,0,0,1
Geo. K. Linderman,0,0,1,0,0,1
Geo. K. Palmer,0,0,1,0,0,1
Geo. Kipp Inc.,0,0,1,0,0,1
Geo. Milligan,0,0,1,0,0,1
Geo. N. Snyder,0,0,1,0,0,1
Geo. O. H. Buchner,0,0,1,0,0,1
Geo. S. Wright,0,0,1,0,0,1
"Geo. Terry Drilling Co., Inc.",0,0,1,0,0,1
Geo. W. Ring & Frank L. Ring,0,0,1,0,0,1
Geo. W. Smith,0,0,1,0,0,1
"Geochemical Surveys, Inc.",0,0,1,0,0,1
Geopetro Resources Company,0,0,1,0,0,1
George A. Grober,0,0,1,0,0,1
George A. Jones,0,0,1,0,0,1
George B. Anderson,0,0,1,0,0,1
George B. Armstrong,0,0,1,0,0,1
George C. Atha,0,0,1,0,0,1
George C. Withers,0,0,1,0,0,1
George D. Rowan,0,0,1,0,0,1
George Duty & Assoc.,0,0,1,0,0,1
George E Almgren,0,0,1,0,0,1
George E. & Lola Vardas,0,0,1,0,0,1
"George E. Cameron, Jr.",0,0,1,0,0,1
George E. Cathcart,0,0,1,0,0,1
George E. Giardina,0,0,1,0,0,1
George E. Wise,0,0,1,0,0,1
George F. Sproul,0,0,1,0,0,1
George H. Marsh,0,0,1,0,0,1
George J. Darneille,0,0,1,0,0,1
George L. Guthrie,0,0,1,0,0,1
George L. Guthrie & Assoc.,0,0,1,0,0,1
George N. Snyder,0,0,1,0,0,1
George O. Gorham,0,0,1,0,0,1
George P. Lyons,0,0,1,0,0,1
George Pepperdine College,0,0,1,0,0,1
George R. Liddle,0,0,1,0,0,1
George R. Rider,0,0,1,0,0,1
George R. Urich,0,0,1,0,0,1
George Sievers,0,0,1,0,0,1
"George Sunday, Jr.",0,0,1,0,0,1
George T. Cameron,0,0,1,0,0,1
George Terry,0,0,1,0,0,1
George Terry Drilling Co.,0,0,1,0,0,1
George W. Arnold,0,0,1,0,0,1
George W. Dean,0,0,1,0,0,1
George W. Milligan & Donald E. Milligan,0,0,1,0,0,1
George W. Owens,0,0,1,0,0,1
George W. Rankin,0,0,1,0,0,1
George W. Ring,0,0,1,0,0,1
George W. Shearer,0,0,1,0,0,1
George W. Smith,0,0,1,0,0,1
George W. Wake,0,0,1,0,0,1
George Wake,0,0,1,0,0,1
George Walters,0,0,1,0,0,1
Gerald Beougher and Dale Beougher,0,0,1,0,0,1
Gerald Carroll,0,0,1,0,0,1
Gerard Ryzek,0,0,1,0,0,1
Gerrard-Grimes Oil Syndicate,0,0,1,0,0,1
Gertie L. Bennett,0,0,1,0,0,1
Getty Oil Co.,0,0,1,0,0,1
Gibson,0,0,1,0,0,1
Gibson-Sullivan,0,0,1,0,0,1
"Gieck Oil Corp., Ltd.",0,0,1,0,0,1
Gilbert Petro. Corp.,0,0,1,0,0,1
Giles E. Wallace,0,0,1,0,0,1
Gill-David Oil Co. Inc.,0,0,1,0,0,1
Gill Oil Company,0,0,1,0,0,1
Gilliland & Lyte Oil Co.,0,0,1,0,0,1
Gilmore & Page Trucking Co.,0,0,1,0,0,1
Ginger Oil Co.,0,0,1,0,0,1
Giovanni Vai,0,0,1,0,0,1
Glen Dial,0,0,1,0,0,1
Glen G. Stone,0,0,1,0,0,1
"Glen H. Mitchel, Operator",0,0,1,0,0,1
Glenn A. Martain,0,0,1,0,0,1
Glenn H. McCarthy,0,0,1,0,0,1
Glick Wind Machine Sales & Rental Inc.,0,0,1,0,0,1
Globe Lease & Royalty Co.,0,0,1,0,0,1
"Globe Minerals, Inc.",0,0,1,0,0,1
"GLR Exploration Co., Ltd.",0,0,1,0,0,1
"Go Energy, Inc.",0,0,1,0,0,1
Gods Right Arm Oil Corp.,0,0,1,0,0,1
Golconda Petro. Corp.,0,0,1,0,0,1
"Gold Crown Pete, Ltd.",0,0,1,0,0,1
Gold Metals Consolidated Mining Co.,0,0,1,0,0,1
Gold Sands Petroleum,0,0,1,0,0,1
Gold Seal Petro. Co.,0,0,1,0,0,1
Gold Tip Oil Co.,0,0,1,0,0,1
Golden Crest Oil Co.,0,0,1,0,0,1
Golden Eagle Rfg. Co. Inc.,0,0,1,0,0,1
Golden Gate Petroleum,0,0,1,0,0,1
Golden Gate Petroleum Co. and United Exploration Co. of Calif.,0,0,1,0,0,1
Golden State Drilling and Producing Co.,0,0,1,0,0,1
"Golden State Expl. Co., Ltd.",0,0,1,0,0,1
Golden Sun International,0,0,1,0,0,1
Goldie & Rosa Steiner,0,0,1,0,0,1
Goldman Oil Syndicate,0,0,1,0,0,1
Goldsmith Bros. Inc. Ltd.,0,0,1,0,0,1
Good-Rich Drilling Co.,0,0,1,0,0,1
"Good-Rich Oil Corp., Ltd.",0,0,1,0,0,1
"Goodknight, Bass & Garner",0,0,1,0,0,1
Goodrich & Hudson,0,0,1,0,0,1
Gordon and Horowitz,0,0,1,0,0,1
Gordon L. Graham,0,0,1,0,0,1
"Gordon Oil and Gas Co., Ltd.",0,0,1,0,0,1
Gorlin and Nelson,0,0,1,0,0,1
Gould Hills Petroleum Corporation,0,0,1,0,0,1
Government Refining & Gasoline Corp.Ltd.,0,0,1,0,0,1
Grace Ewing,0,0,1,0,0,1
Grace Oil Co.,0,0,1,0,0,1
Gracekern Oil Co.,0,0,1,0,0,1
Graham & Dewitt,0,0,1,0,0,1
Graham Loftus Oil Corp.,0,0,1,0,0,1
Granada Energy Corp.,0,0,1,0,0,1
"Grand View Oil Co., Ltd.",0,0,1,0,0,1
Grande Petro. Co.,0,0,1,0,0,1
"Granite Dev. Co., Inc.",0,0,1,0,0,1
Grant Owens,0,0,1,0,0,1
Grapevine Canon Oil Co.,0,0,1,0,0,1
Graphic Oil Corp.,0,0,1,0,0,1
Graves Oil Co.,0,0,1,0,0,1
Gravity Expl. Co.,0,0,1,0,0,1
Great Coastal Oil Corp.,0,0,1,0,0,1
Great Lakes Oil & Chemical Co.,0,0,1,0,0,1
Great Republic Oil & Paint Co.,0,0,1,0,0,1
Great Valley Dev. Co.,0,0,1,0,0,1
"Great Valley Petroleum, Inc.",0,0,1,0,0,1
Great West Oil Co.,0,0,1,0,0,1
Great Western Pacific Corp.,0,0,1,0,0,1
Great Western Petro. Corp.,0,0,1,0,0,1
Greater Stanta Cruz Oil Corp.,0,0,1,0,0,1
Green Oil Tunnel,0,0,1,0,0,1
Green Oil Wells,0,0,1,0,0,1
Green Petroleum Co.,0,0,1,0,0,1
"Gregg Drilling, Inc.",0,0,1,0,0,1
Gretna Corp.,0,0,1,0,0,1
"Grey-Holmes, Operator",0,0,1,0,0,1
Griffith & Arthur,0,0,1,0,0,1
Griffiths-Boehme Oil Co.,0,0,1,0,0,1
Grizzly Energy LLC,0,0,1,0,0,1
Groshen Oil Co.,0,0,1,0,0,1
"Group Oil Operators, Inc.",0,0,1,0,0,1
Grover Herring,0,0,1,0,0,1
Grunwell Oil Corp.,0,0,1,0,0,1
Guarantee Oil Co.,0,0,1,0,0,1
Guaranty Securities Co. Ltd.,0,0,1,0,0,1
Guiberson-Burke Co.,0,0,1,0,0,1
Guiberson-Cudahy,0,0,1,0,0,1
Gulf Oil (Trans AM Develop,0,0,1,0,0,1
Gulf Pacific Cable Co.,0,0,1,0,0,1
Gulf Verde Oil Co.,0,0,1,0,0,1
Gunnar Erikson,0,0,1,0,0,1
Guy L. Wiggs,0,0,1,0,0,1
Guy Richardson,0,0,1,0,0,1
"Gypsy Oil Syndicate, Inc.",0,0,1,0,0,1
H-K Exploartion Co.,0,0,1,0,0,1
H & H Oil Co.,0,0,1,0,0,1
"H & L Drilling Co., Inc.",0,0,1,0,0,1
H & L Operators,0,0,1,0,0,1
H & L Supply,0,0,1,0,0,1
H & M Oil Well,0,0,1,0,0,1
H & W Oil Producing Co.,0,0,1,0,0,1
H & W Williams Drilling,0,0,1,0,0,1
H. & C. Oil Co.,0,0,1,0,0,1
H. & R. Oil Company,0,0,1,0,0,1
H. & W. & Assoc. Ltd.,0,0,1,0,0,1
H. A. Pagenkopf,0,0,1,0,0,1
H. A. Waters,0,0,1,0,0,1
H. B. Betts Oil Co.,0,0,1,0,0,1
H. B. Proctor,0,0,1,0,0,1
H. C. Christie,0,0,1,0,0,1
H. C. Domengeaux,0,0,1,0,0,1
H. C. Morton & H.S. Kohlbush,0,0,1,0,0,1
H. C. Production LLC,0,0,1,0,0,1
"H. E. Havenstrite, Trustee",0,0,1,0,0,1
H. E. Miller,0,0,1,0,0,1
"H. E. Reynolds, Jr.",0,0,1,0,0,1
H. G. Haney,0,0,1,0,0,1
H. G. Reynolds,0,0,1,0,0,1
H. H. Humphreys,0,0,1,0,0,1
H. H. Jenkins,0,0,1,0,0,1
H. H. McVicar,0,0,1,0,0,1
H. H. Myers,0,0,1,0,0,1
H. H. Pierce & Co.,0,0,1,0,0,1
H. Hottinger & A.J. Kennedy,0,0,1,0,0,1
H. J. Crawford,0,0,1,0,0,1
H. J. Farrington,0,0,1,0,0,1
H. J. Hanna,0,0,1,0,0,1
H. J. Henry,0,0,1,0,0,1
H. J. Kirschenman & A. J. Rogers,0,0,1,0,0,1
H. J. Raid,0,0,1,0,0,1
H. J. Wheeler,0,0,1,0,0,1
H. L. Harvill,0,0,1,0,0,1
H. L. J. Oil Co.,0,0,1,0,0,1
"H. L. J. Oil Co., Ltd.",0,0,1,0,0,1
H. L. Lericker,0,0,1,0,0,1
H. L. S. Oil Corp.,0,0,1,0,0,1
H. L. Sanborn & Sons,0,0,1,0,0,1
"H. L. Shepard & Sons, Operators",0,0,1,0,0,1
"H. L. Whiston, Sr.",0,0,1,0,0,1
H. M. Anthony,0,0,1,0,0,1
H. M. Anthony & W.C. Werle,0,0,1,0,0,1
H. May Co.,0,0,1,0,0,1
H. N. Royden & Associates,0,0,1,0,0,1
H. P Oates & Irene L. Oates,0,0,1,0,0,1
H. P. & B. Oil Co.,0,0,1,0,0,1
H. P. Oats,0,0,1,0,0,1
H. R. Earp,0,0,1,0,0,1
H. R. Wiseman,0,0,1,0,0,1
H. S. Douglas,0,0,1,0,0,1
H. S. Rothschild No. 1 Explor.,0,0,1,0,0,1
H. S./H A/ & J H Russell,0,0,1,0,0,1
H. T. Widney and G. G. Widney,0,0,1,0,0,1
H. V. Gentry Corp.,0,0,1,0,0,1
H. W. & W. Melvin Killingsworth,0,0,1,0,0,1
H. W. Orwig,0,0,1,0,0,1
H. W. Stepp,0,0,1,0,0,1
H.C.L. Syndicate,0,0,1,0,0,1
H.F.S. Sales,0,0,1,0,0,1
H.K.R. Oil Co.,0,0,1,0,0,1
H.L.F. Oil Company,0,0,1,0,0,1
Habco Oil Co.,0,0,1,0,0,1
"Hagerty & Caine, Tr.",0,0,1,0,0,1
Hal R. Bourne,0,0,1,0,0,1
Half Moon Oil,0,0,1,0,0,1
Halvern L Norris & Assoc,0,0,1,0,0,1
"Hamar II Associates, LLC",0,0,1,0,0,1
Hames Valley Devl Co.,0,0,1,0,0,1
Hamilton Petroleum Corp.,0,0,1,0,0,1
"Hamilton Res., Inc.",0,0,1,0,0,1
Hamiltonian Oil Co.,0,0,1,0,0,1
Hammer-Glidden Corp.,0,0,1,0,0,1
Hammond Petroleum Corp.,0,0,1,0,0,1
Hampton C Robinson Jr,0,0,1,0,0,1
Haney & Williams Drilling Co,0,0,1,0,0,1
Hans R. Sumpf,0,0,1,0,0,1
Hansco Oil,0,0,1,0,0,1
"Hapcamp, Limited Partnership",0,0,1,0,0,1
Harbor Petroleum Corp.,0,0,1,0,0,1
Harken Oil & Gas Inc.,0,0,1,0,0,1
Harmony Lorraine Oil Syndicate,0,0,1,0,0,1
Harmony Rose Oil Syndicate,0,0,1,0,0,1
Harmony Taylor Oil Syndicate,0,0,1,0,0,1
Harmor Petro. Co.,0,0,1,0,0,1
Harold A. Gilman and J. Farbstein,0,0,1,0,0,1
Harold B. Landoth et al,0,0,1,0,0,1
Harold C. Morton & H. S. Kohlbush,0,0,1,0,0,1
Harold D. Gregg,0,0,1,0,0,1
"Harold E. Purdum, et ux & Son",0,0,1,0,0,1
Harold E. Willhoit & John D. Willhoit,0,0,1,0,0,1
"Harold H. Gartner, Sr.",0,0,1,0,0,1
Harold Hagen and Associates,0,0,1,0,0,1
"Harold Hagen, Ray Hagen, Frank Clegg",0,0,1,0,0,1
"Harp & Brown, Operators",0,0,1,0,0,1
"Harr Petroleum Co., Ltd.",0,0,1,0,0,1
Harrell Drilling Co.,0,0,1,0,0,1
Harris Canyon Assoc.,0,0,1,0,0,1
"Harris Road Properties, LLC",0,0,1,0,0,1
Harrison Producing Co.,0,0,1,0,0,1
Harry A. Mart,0,0,1,0,0,1
Harry Basher,0,0,1,0,0,1
Harry Blank,0,0,1,0,0,1
Harry Briggs,0,0,1,0,0,1
Harry C. Long,0,0,1,0,0,1
Harry C. Noonan & Co.,0,0,1,0,0,1
Harry E. Hernandez,0,0,1,0,0,1
Harry E. Lee,0,0,1,0,0,1
Harry E. MacAdam,0,0,1,0,0,1
Harry Farren,0,0,1,0,0,1
Harry H. Briggs,0,0,1,0,0,1
Harry H. Hillman,0,0,1,0,0,1
Harry H. Pegors,0,0,1,0,0,1
Harry Hunter-J. P. Thurmond,0,0,1,0,0,1
Harry J. Hill,0,0,1,0,0,1
"Harry J. Hill, Oper.",0,0,1,0,0,1
Harry J. Riskas,0,0,1,0,0,1
"Harry Klassman, Oper.",0,0,1,0,0,1
Harry L. Hopkins (Deceased),0,0,1,0,0,1
Harry S. Rothschild & Co.,0,0,1,0,0,1
Harry S. Rothschild & Josephine E. Ro.,0,0,1,0,0,1
Harry S. Sankey,0,0,1,0,0,1
"Harry W. Wilson, Jr.",0,0,1,0,0,1
Hart Expl. & Prod. Co.,0,0,1,0,0,1
Hartford Oil Co.,0,0,1,0,0,1
"Harvest Natural Resources, Inc.",0,0,1,0,0,1
Harvester Gas Field Development Company,0,0,1,0,0,1
Harvey L. Decker,0,0,1,0,0,1
"Haslam, Love & Culbertson, Inc., Ltd.",0,0,1,0,0,1
Haussler Farms Inc.,0,0,1,0,0,1
Hayes-Jenkins Investment Co.,0,0,1,0,0,1
"Hayward Oil Co., Ltd.",0,0,1,0,0,1
Healy & Neylan,0,0,1,0,0,1
Hearrell Oil Co.,0,0,1,0,0,1
"Hedges, Smith & Erlich",0,0,1,0,0,1
Hedley Builders,0,0,1,0,0,1
"Heffern Oil Co., Inc.",0,0,1,0,0,1
Heinz H. Herrmann,0,0,1,0,0,1
"Helen Petroleum Corp., Ltd.",0,0,1,0,0,1
Helen Yarrow,0,0,1,0,0,1
Helena C. & David E. Parker,0,0,1,0,0,1
Helm and Prewett,0,0,1,0,0,1
Helm Co. & Hans R. Sumpf,0,0,1,0,0,1
Helm Syndicate,0,0,1,0,0,1
"Heltur Oil Co., Ltd.",0,0,1,0,0,1
Hembrook Oil Co.,0,0,1,0,0,1
Henderson Oil & Dev. Co.,0,0,1,0,0,1
Henry And Jane Fong,0,0,1,0,0,1
Henry Berrie Fish,0,0,1,0,0,1
Henry Cartan,0,0,1,0,0,1
Henry D. McCoy,0,0,1,0,0,1
Henry De Mond,0,0,1,0,0,1
Henry E. Luttge,0,0,1,0,0,1
Henry F. Bloomfield,0,0,1,0,0,1
Henry F. Bloomfield (Mrs.),0,0,1,0,0,1
"Henry F. Bloomfield, Trustee",0,0,1,0,0,1
Henry Hottinger,0,0,1,0,0,1
Henry King,0,0,1,0,0,1
Henry Larrucca,0,0,1,0,0,1
Henry M. Wilson,0,0,1,0,0,1
Henry O. Arras,0,0,1,0,0,1
"Henry R. Dabney, Trustee",0,0,1,0,0,1
Henry Robinett,0,0,1,0,0,1
Henry T. Giller and William P. Spaugh,0,0,1,0,0,1
Henry Wertalla,0,0,1,0,0,1
Herbert E. Adams,0,0,1,0,0,1
Herbert H. Twisselmann,0,0,1,0,0,1
Herbert Moore,0,0,1,0,0,1
Herley-Callahan Operators,0,0,1,0,0,1
Herley-Kelley Prod. Co.,0,0,1,0,0,1
Herley Petroleum,0,0,1,0,0,1
Herlindah Gallegos,0,0,1,0,0,1
Herman B. Graves,0,0,1,0,0,1
Herman T. Eade,0,0,1,0,0,1
Herndon Dev. Co.,0,0,1,0,0,1
Herndon Petro. Corp.,0,0,1,0,0,1
Hernul Oil Co.,0,0,1,0,0,1
"Herschel L. Copelan, M.D.",0,0,1,0,0,1
Hess Corporation,0,0,1,0,0,1
Hess Oil Co.,0,0,1,0,0,1
Hetman-Can Exploration Co.,0,0,1,0,0,1
Hetman-Canning Co.,0,0,1,0,0,1
Hewitt Oil Co.,0,0,1,0,0,1
Hexadyne Drilling Corp.,0,0,1,0,0,1
Hickory Creek Oil Co.,0,0,1,0,0,1
Hickory Creek Oil Co. & Hickory-National Co.,0,0,1,0,0,1
Hickory Creek Oil Co. & Hickory Nat. Co.,0,0,1,0,0,1
Hidalgo Oil Co.,0,0,1,0,0,1
High Mesa Oil Co.,0,0,1,0,0,1
Highland Dev. Co.,0,0,1,0,0,1
Highland Drilling Co.,0,0,1,0,0,1
"Highlin Oil Co., Inc. Ltd.",0,0,1,0,0,1
Hileford Assoc.,0,0,1,0,0,1
Hill & Grumbaugh,0,0,1,0,0,1
Hillman Oil Co.,0,0,1,0,0,1
Hillview Oil Co.,0,0,1,0,0,1
Hilmar Comm. Oil & Gas Co.,0,0,1,0,0,1
"Hines Petro. Corp., Ltd.",0,0,1,0,0,1
Hitchcock & Cottle,0,0,1,0,0,1
Hobbs Petro.,0,0,1,0,0,1
Hodge & Hogan,0,0,1,0,0,1
Hodgman Lease,0,0,1,0,0,1
"Hogan & Lytle, Inc.",0,0,1,0,0,1
Hoke L. Woodward,0,0,1,0,0,1
"Hol-Har I, Inc.",0,0,1,0,0,1
Holbrook Petro. Corp.,0,0,1,0,0,1
Holden Petro. Corp.,0,0,1,0,0,1
Hollandia Oil Assoc.,0,0,1,0,0,1
Hollister Oil & Expl. Co.,0,0,1,0,0,1
Hollister Oil & Gas Co.,0,0,1,0,0,1
Holly Oil Co.,0,0,1,0,0,1
Holly Sugar Corp.,0,0,1,0,0,1
Hollywood Oil Corp.,0,0,1,0,0,1
Hollywood Turf Club,0,0,1,0,0,1
Holmes & Hott,0,0,1,0,0,1
Holmes Drilling Co.,0,0,1,0,0,1
"Home Corp., Ltd.",0,0,1,0,0,1
Homer F. West,0,0,1,0,0,1
Homer Grizzle,0,0,1,0,0,1
Homer Hatcher,0,0,1,0,0,1
"Hondo Oil Co., Inc.",0,0,1,0,0,1
Hondo Oil Company,0,0,1,0,0,1
Honey Lake Exploration,0,0,1,0,0,1
Hope Oil Co.,0,0,1,0,0,1
Hopland Oil Co.,0,0,1,0,0,1
Hopper Canyon Oil Co.,0,0,1,0,0,1
"Horace Steele, Oper.",0,0,1,0,0,1
"Hotz & Naron, Operators",0,0,1,0,0,1
"Houston Bixby, Inc",0,0,1,0,0,1
Hovey Hills Oil Company,0,0,1,0,0,1
Howard E. Williams,0,0,1,0,0,1
Howard H. Lange,0,0,1,0,0,1
Howard P. House,0,0,1,0,0,1
Howard S. Martin,0,0,1,0,0,1
Howard S. Mountford,0,0,1,0,0,1
Howard T. Widney,0,0,1,0,0,1
Howell and Thomas,0,0,1,0,0,1
Hoyt & Company Son Lease,0,0,1,0,0,1
Hoyt & Wilson,0,0,1,0,0,1
"HQT Highland Placentia, LLC",0,0,1,0,0,1
Hub Petroleum Corp.,0,0,1,0,0,1
Hubbard S. Russell,0,0,1,0,0,1
Huberand McGinnis,0,0,1,0,0,1
Hubro Oil Corp.,0,0,1,0,0,1
Hudson & Terry,0,0,1,0,0,1
Hudson D. Wilcox,0,0,1,0,0,1
"Hudson Oil Co., Inc.",0,0,1,0,0,1
"Hugh Grant (Robert Bromberg, Trustee)",0,0,1,0,0,1
Hugh L. Dobbins,0,0,1,0,0,1
Hugh McMillan,0,0,1,0,0,1
Hugh T. Harrison,0,0,1,0,0,1
Hugh Ward Lutz,0,0,1,0,0,1
Hughes Aircraft Co.,0,0,1,0,0,1
Hullhorst Oil Co.,0,0,1,0,0,1
Hunsaker & Atha,0,0,1,0,0,1
Hunter Petroleum Company,0,0,1,0,0,1
Huntington Valley Church,0,0,1,0,0,1
Husky Oil Co. of Delaware,0,0,1,0,0,1
"Hy Seiden and Edward M. Tilbury, Operators",0,0,1,0,0,1
Hydril Co.,0,0,1,0,0,1
Hydro Carbon Products Co.,0,0,1,0,0,1
Hydrocarbons Ltd.,0,0,1,0,0,1
Hylton Drilling Co.,0,0,1,0,0,1
Hysom & Young,0,0,1,0,0,1
I. A. Skidmore,0,0,1,0,0,1
I. H. Larson & M. U. Stanford,0,0,1,0,0,1
I.J. McCullough,0,0,1,0,0,1
Idria Petro. Corp.,0,0,1,0,0,1
Illini Development Company,0,0,1,0,0,1
Illuminating Petro. Well No. 1,0,0,1,0,0,1
"Imperial Dev. Co., Ltd.",0,0,1,0,0,1
Indian Dome Oil Co.,0,0,1,0,0,1
Indian Oil Company,0,0,1,0,0,1
Industrial Oil Synd. #2,0,0,1,0,0,1
Industrial Royalties Co.,0,0,1,0,0,1
"Inland Assoc., Ltd.",0,0,1,0,0,1
Inland Pacific Co.,0,0,1,0,0,1
"Inland Petro. Co., Ltd.",0,0,1,0,0,1
"Inland Valley Oil Co., Ltd.",0,0,1,0,0,1
Inspiration Oil Co.,0,0,1,0,0,1
Inter-Coast Oil & Transport Co. Ltd.,0,0,1,0,0,1
Inter-Counties Petro. Co.,0,0,1,0,0,1
"Inter-State Lubricants, Inc. & C.R. Butz",0,0,1,0,0,1
International Brooks Petroleum Ltd.,0,0,1,0,0,1
International Exploration Corp.,0,0,1,0,0,1
International Industrial Corp.,0,0,1,0,0,1
International Petro. Co.,0,0,1,0,0,1
International Petro. Consul,0,0,1,0,0,1
Interquest Resources Corp.,0,0,1,0,0,1
Interstate Service Co.,0,0,1,0,0,1
Intrepid Oil Co.,0,0,1,0,0,1
Invader Oil Co.,0,0,1,0,0,1
Investment Trends Corp.,0,0,1,0,0,1
Ira Gershwin & Assoc.,0,0,1,0,0,1
Ira M. Jones,0,0,1,0,0,1
Irani Engineering,0,0,1,0,0,1
Irex Oil Co.,0,0,1,0,0,1
Irex Operating Co.,0,0,1,0,0,1
"Irma Investment Corp., Ltd.",0,0,1,0,0,1
"Irving H. Whitehouse, Janice C. Whitehouse, Wayne Wilcox, and Helen Colgrove Wilcox",0,0,1,0,0,1
Irwin-Carlson-Irwin Operations Co.,0,0,1,0,0,1
Isaac M. Stewart,0,0,1,0,0,1
Island View Oil Co.,0,0,1,0,0,1
Isler & Turk,0,0,1,0,0,1
Italo-American Petro. Corp.,0,0,1,0,0,1
"Itasca Petro. Co., Ltd.",0,0,1,0,0,1
Ito Oil Co.,0,0,1,0,0,1
"Ivan J. Vojvoda, Oper.",0,0,1,0,0,1
Ivan Vojvoda & Albert A. George,0,0,1,0,0,1
"Ivanpah Oil Assoc., Ltd.",0,0,1,0,0,1
Ivanpah Partnership,0,0,1,0,0,1
J & D Oil Co.,0,0,1,0,0,1
J Ainslie Bell Opr For,0,0,1,0,0,1
J B Oil Co.,0,0,1,0,0,1
J Oil Co.,0,0,1,0,0,1
J. A. Kibele,0,0,1,0,0,1
J. A. Meekin,0,0,1,0,0,1
J. A. Scholler,0,0,1,0,0,1
"J. A. Smith, Trustee",0,0,1,0,0,1
J. B. Halbert,0,0,1,0,0,1
J. B. Parson and Gary Sprouse,0,0,1,0,0,1
J. B. Threadwell,0,0,1,0,0,1
J. C. Anderson,0,0,1,0,0,1
J. C. Drilling Co.,0,0,1,0,0,1
J. C. Hansmeyer,0,0,1,0,0,1
J. C. Maddy,0,0,1,0,0,1
J. D. Dalton & E. F. Sharkey,0,0,1,0,0,1
J. D. Langford & Co.,0,0,1,0,0,1
J. D. Manley For Dugger & Manley,0,0,1,0,0,1
J. D. Phalen,0,0,1,0,0,1
"J. D. Wrather, Jr.",0,0,1,0,0,1
J. E. Baker,0,0,1,0,0,1
J. E. Braun,0,0,1,0,0,1
J. E. Burney Syndicate No. 1,0,0,1,0,0,1
J. E. Cowles,0,0,1,0,0,1
J. E. F. Oil Co.,0,0,1,0,0,1
J. E. Ford,0,0,1,0,0,1
J. E. Hall,0,0,1,0,0,1
"J. E. Logan, Jr.",0,0,1,0,0,1
J. E. Russell,0,0,1,0,0,1
J. E. Ward,0,0,1,0,0,1
J. E. Willette,0,0,1,0,0,1
J. F. Garliepp,0,0,1,0,0,1
J. F. Reddick,0,0,1,0,0,1
"J. F. Wilcox, Operator",0,0,1,0,0,1
J. G. Dyer,0,0,1,0,0,1
J. G. Wheeler,0,0,1,0,0,1
J. Glen Crist & Juliet H. Crist,0,0,1,0,0,1
J. H. Fawcett,0,0,1,0,0,1
J. H. Fiske-H.G. Spengler & H.R. Dabney,0,0,1,0,0,1
J. H. Henion,0,0,1,0,0,1
"J. H. Jordan, Batz and Hay",0,0,1,0,0,1
J. H. Macklin,0,0,1,0,0,1
J. H. Siemon,0,0,1,0,0,1
J. H. Walton,0,0,1,0,0,1
J. I. Anderson,0,0,1,0,0,1
J. I. Listle,0,0,1,0,0,1
J. J. Cairns,0,0,1,0,0,1
J. J. Kelly,0,0,1,0,0,1
J. J. Koshak,0,0,1,0,0,1
J. J. Munding,0,0,1,0,0,1
"J. J. Tavis, Incorporated",0,0,1,0,0,1
J. K. Fisher,0,0,1,0,0,1
J. K. Kesson and Everett H. Jones,0,0,1,0,0,1
J. Kessler & Assoc.,0,0,1,0,0,1
J. M. Cummins,0,0,1,0,0,1
J. M. Kellerman and Thos. Vigus,0,0,1,0,0,1
J. M. Queen,0,0,1,0,0,1
J. N. Phillips,0,0,1,0,0,1
J. O. Lamb,0,0,1,0,0,1
J. Oscar Smith,0,0,1,0,0,1
J. Oscar Smith Co.,0,0,1,0,0,1
J. P. Girotti,0,0,1,0,0,1
J. R. and M.B. Fithian,0,0,1,0,0,1
J. R. Cannon,0,0,1,0,0,1
J. R. Canterbury,0,0,1,0,0,1
J. R. George,0,0,1,0,0,1
J. R. Pemberton,0,0,1,0,0,1
"J. Robert Phillips, Jr.",0,0,1,0,0,1
J. S. & A M Edwards,0,0,1,0,0,1
J. S. & L. Co.,0,0,1,0,0,1
J. S. Cullinan Ii,0,0,1,0,0,1
J. S. Manley,0,0,1,0,0,1
J. T. Hurst,0,0,1,0,0,1
J. T. Wilcox,0,0,1,0,0,1
J. V. Smith,0,0,1,0,0,1
J. W. B. Oil Co.,0,0,1,0,0,1
J. W. Bonneville,0,0,1,0,0,1
J. W. Grafford,0,0,1,0,0,1
J. W. Hackworth,0,0,1,0,0,1
J. W. Martin,0,0,1,0,0,1
J. W. Mosher,0,0,1,0,0,1
"J. W. Todd Oil Co., Ltd.",0,0,1,0,0,1
J. W. Vandeveer,0,0,1,0,0,1
J. W. Weaver,0,0,1,0,0,1
J. W. Wood,0,0,1,0,0,1
J. Walter Van Atta & Assoc.,0,0,1,0,0,1
J.L.J. Oil Operations,0,0,1,0,0,1
Jacalitos Oil Co.,0,0,1,0,0,1
"Jacalitos Petro. Co., Oper.",0,0,1,0,0,1
Jack Brown,0,0,1,0,0,1
Jack H. Bennett,0,0,1,0,0,1
Jack Herley Operations,0,0,1,0,0,1
"Jack Marantz, Ltd. Partnership",0,0,1,0,0,1
"Jack McFarland, Operator",0,0,1,0,0,1
Jack P Burke,0,0,1,0,0,1
Jack Radovich,0,0,1,0,0,1
"Jack Sullivan, Operator",0,0,1,0,0,1
Jack Thomas,0,0,1,0,0,1
"Jack W. Wood, Operator",0,0,1,0,0,1
Jack Yetman,0,0,1,0,0,1
Jackson & Jackson,0,0,1,0,0,1
"Jackson, Pearson & Todd",0,0,1,0,0,1
Jacob Albert,0,0,1,0,0,1
Jacobson-Colusa Oil Co.,0,0,1,0,0,1
"Jacobson-Evans Petroleum Co., Ltd.",0,0,1,0,0,1
Jacobson-Vista Grande Ltd.,0,0,1,0,0,1
Jacobson Oil & Gas Co.,0,0,1,0,0,1
Jacobson Oil Co.,0,0,1,0,0,1
Jahn's Oil Co.,0,0,1,0,0,1
James B. & Archie A. MacDonald,0,0,1,0,0,1
"James C. Brazell, Trustee",0,0,1,0,0,1
James C. Haggard & Assoc.,0,0,1,0,0,1
James C. Hannah,0,0,1,0,0,1
James Davidson,0,0,1,0,0,1
James E. Farned,0,0,1,0,0,1
James E. King & Evert Pickerel,0,0,1,0,0,1
James F. Collins,0,0,1,0,0,1
James F. Whitehorn,0,0,1,0,0,1
James Fischgrund,0,0,1,0,0,1
James Fischgrund & Monarch O&G,0,0,1,0,0,1
James H. Dondich,0,0,1,0,0,1
James H. McCue & Cliff E. Zillgitt,0,0,1,0,0,1
James H. Sewell,0,0,1,0,0,1
James Herley Petroleum,0,0,1,0,0,1
James Jansen,0,0,1,0,0,1
James K. Aurness,0,0,1,0,0,1
James Lee Aydelott Operations,0,0,1,0,0,1
James M. Conlon Co.,0,0,1,0,0,1
James M. Douglas,0,0,1,0,0,1
James M. Irish,0,0,1,0,0,1
James Michelin,0,0,1,0,0,1
"James N. Routh, Oper.",0,0,1,0,0,1
James P Thorup,0,0,1,0,0,1
James R. Price,0,0,1,0,0,1
James R. Saul,0,0,1,0,0,1
James R. Tweedy,0,0,1,0,0,1
James R. Wylie & Edward M. Tilbury,0,0,1,0,0,1
"James Rhoten Farned, La Vally & Greer",0,0,1,0,0,1
James Simms,0,0,1,0,0,1
Jameson Oil  Co.,0,0,1,0,0,1
Jamieson-West,0,0,1,0,0,1
Jas E. Conniff,0,0,1,0,0,1
Jasmin Hackel Associates,0,0,1,0,0,1
Jasmine Oil Co.,0,0,1,0,0,1
Jasper Petro. Corp.,0,0,1,0,0,1
Jasper Petroleum Co.,0,0,1,0,0,1
"Jayhawk Exploration, Inc.",0,0,1,0,0,1
"JCG Energy Investors #1, LLC",0,0,1,0,0,1
Jean & Mary Casenave,0,0,1,0,0,1
Jeanne E. Nevins,0,0,1,0,0,1
Jeans Well Service,0,0,1,0,0,1
Jeff J. Stephens,0,0,1,0,0,1
Jefferson Petroleum Company,0,0,1,0,0,1
Jem Petro. Corp.,0,0,1,0,0,1
Jene D Munson,0,0,1,0,0,1
Jennings Drilling Co.,0,0,1,0,0,1
Jennings Syndicate,0,0,1,0,0,1
Jergins Oil Co.,0,0,1,0,0,1
Jeroil Corp. Ltd.,0,0,1,0,0,1
"Jesse Coykendall, et al",0,0,1,0,0,1
Jesse M. Nelson,0,0,1,0,0,1
Jewett & Blodget,0,0,1,0,0,1
Jim Brown and Elmer L. Knotts,0,0,1,0,0,1
Jim Graham,0,0,1,0,0,1
"JK Pacific Group, LLC",0,0,1,0,0,1
Jnj Corp.,0,0,1,0,0,1
Joaquin Petroleum Corp.,0,0,1,0,0,1
Jocar Oil Co.,0,0,1,0,0,1
Joe B. Hudson,0,0,1,0,0,1
Joe Ferring,0,0,1,0,0,1
Joe M. Anderson,0,0,1,0,0,1
Joe R. Thompson & Mary Thompson,0,0,1,0,0,1
Joel Brandon,0,0,1,0,0,1
John A. Kochergen,0,0,1,0,0,1
John A. Rothschild & Dorothy Rothschild,0,0,1,0,0,1
"John A. Woodward, Jr.",0,0,1,0,0,1
"John B. De Maria, Jr.",0,0,1,0,0,1
John B. Luden,0,0,1,0,0,1
John Baldwin,0,0,1,0,0,1
John Barneson et al,0,0,1,0,0,1
John Baron,0,0,1,0,0,1
John Bybee & Assoc.,0,0,1,0,0,1
John C. Gamba,0,0,1,0,0,1
John Camphouse,0,0,1,0,0,1
John D. Manley III,0,0,1,0,0,1
John E. Hill,0,0,1,0,0,1
John Elrich,0,0,1,0,0,1
John F. Gallagher,0,0,1,0,0,1
John F. Gallagher and W. C. Tomlin,0,0,1,0,0,1
"John F. Howells, Jr., Trustee",0,0,1,0,0,1
John F. Lingo,0,0,1,0,0,1
John F. Phillips,0,0,1,0,0,1
John F. Sheran,0,0,1,0,0,1
John F. Wilcox,0,0,1,0,0,1
John G. Sedgwick,0,0,1,0,0,1
John H. Guthrie,0,0,1,0,0,1
John H. Marion,0,0,1,0,0,1
John H. Webb,0,0,1,0,0,1
"John Hokom Oil & Gasoline Co., Ltd.",0,0,1,0,0,1
John I. Pankratz,0,0,1,0,0,1
John Italiani,0,0,1,0,0,1
John J. Moran,0,0,1,0,0,1
John J. Reynolds,0,0,1,0,0,1
John K. Porter,0,0,1,0,0,1
John Knudsen,0,0,1,0,0,1
John L. Fletcher,0,0,1,0,0,1
John L. Scott,0,0,1,0,0,1
John Lewis,0,0,1,0,0,1
John Lloyd Butler Trust,0,0,1,0,0,1
John M. Abrams,0,0,1,0,0,1
John M. Stahl,0,0,1,0,0,1
John McKeon,0,0,1,0,0,1
John McKeon & Edwin A. Fox,0,0,1,0,0,1
John McKeon and Assoc.,0,0,1,0,0,1
John P. Flaming & John Surber,0,0,1,0,0,1
John S & Archie Edwards,0,0,1,0,0,1
John S. Pehar,0,0,1,0,0,1
John Sandburg & Louis Carlson,0,0,1,0,0,1
John Stephen Horn,0,0,1,0,0,1
John W Lucas Jr,0,0,1,0,0,1
John W. Austin,0,0,1,0,0,1
John W. Brashears,0,0,1,0,0,1
John W. Brubaker,0,0,1,0,0,1
John W. Leonard & L. Restrepo,0,0,1,0,0,1
John W. Sherman,0,0,1,0,0,1
John Walklin,0,0,1,0,0,1
Johnson et al,0,0,1,0,0,1
Johnson Oil Co.,0,0,1,0,0,1
"Johnston, Owen and Baker",0,0,1,0,0,1
Jonata Oil Co.,0,0,1,0,0,1
Jorgensen Petro. Co.,0,0,1,0,0,1
"Jose Oil Co., Ltd.",0,0,1,0,0,1
"Joseph Faria, Jr.",0,0,1,0,0,1
Joseph H. Olson,0,0,1,0,0,1
Joseph K. Morford II,0,0,1,0,0,1
Joseph M. Devere,0,0,1,0,0,1
Joseph Stalder,0,0,1,0,0,1
Joseph W. Aidlin & R.E. Bering,0,0,1,0,0,1
Joseph W. Drown,0,0,1,0,0,1
Josephine A. Jones Survivors Trust,0,0,1,0,0,1
Jotec Oil Co.,0,0,1,0,0,1
JP Oil Co.,0,0,1,0,0,1
JROC,0,0,1,0,0,1
Juanita Oil,0,0,1,0,0,1
Juanita Oil Co.,0,0,1,0,0,1
Judy K. Oil Co. Ltd.,0,0,1,0,0,1
Julia Crawford Ivers,0,0,1,0,0,1
Julian J. Miley,0,0,1,0,0,1
Juliette S. Harding Oil Co.,0,0,1,0,0,1
Julio V. Dougherty,0,0,1,0,0,1
Julius and Dorothy Fried,0,0,1,0,0,1
Julius E. Dietzmann,0,0,1,0,0,1
Justic Oil Co.,0,0,1,0,0,1
JVA Oil Co.,0,0,1,0,0,1
K-D Prod. Co.,0,0,1,0,0,1
K & M Oil,0,0,1,0,0,1
"K. & G. Oil Co., Inc.",0,0,1,0,0,1
K. C. Oil Co.,0,0,1,0,0,1
K. C. Wallace and H. J. Leutholtz,0,0,1,0,0,1
K. F. Gill,0,0,1,0,0,1
K. F. Ross,0,0,1,0,0,1
K. G. H. Enterprises,0,0,1,0,0,1
K. H. Day,0,0,1,0,0,1
K. H. Hunter-D J Paden,0,0,1,0,0,1
K. H. Kruse,0,0,1,0,0,1
K. J. Enterprises LLC,0,0,1,0,0,1
K. Sande Senness,0,0,1,0,0,1
K. Sims,0,0,1,0,0,1
Kaar Oil Co.,0,0,1,0,0,1
Kaiser Oil (U.S.) Ltd.,0,0,1,0,0,1
Karnak Gas Expl. Program,0,0,1,0,0,1
"Kashm Oil Corp., Inc.",0,0,1,0,0,1
Kate V. Lopez & P.J. Lopez,0,0,1,0,0,1
Kaweah Oil Dev. Co.,0,0,1,0,0,1
Kay-Dee Co.,0,0,1,0,0,1
KAYCO Oil Co.,0,0,1,0,0,1
KB Home Coastal Inc.,0,0,1,0,0,1
Keck and McWherter,0,0,1,0,0,1
Keck Investment Co.,0,0,1,0,0,1
Keck Syndicate #3,0,0,1,0,0,1
Kelly Petro. Co.,0,0,1,0,0,1
Kelmar Oil Co.,0,0,1,0,0,1
Keloil Inc.,0,0,1,0,0,1
Kelter Bros.,0,0,1,0,0,1
Kemper Oil & Assoc.,0,0,1,0,0,1
Ken-Cal Oil Co.,0,0,1,0,0,1
Ken Pac,0,0,1,0,0,1
Kenber Oil Co.,0,0,1,0,0,1
"Kendall Development Co., Ltd.",0,0,1,0,0,1
Kendo Prod. Co.,0,0,1,0,0,1
Kennedy Co.,0,0,1,0,0,1
"Kennedy Land Co., Inc.",0,0,1,0,0,1
Kenneth A Holmes,0,0,1,0,0,1
"Kenneth C. Tyler, Trustee",0,0,1,0,0,1
"Kenneth C. Tyler, Trustee for John C. Tyler",0,0,1,0,0,1
Kenneth Chen,0,0,1,0,0,1
Kenneth E. Reed,0,0,1,0,0,1
"Kenneth H. Hunter, Jr. Petroleum",0,0,1,0,0,1
Kenneth M. Byrum & Dwight E. Byrum,0,0,1,0,0,1
Kenneth Oil Producing Co.,0,0,1,0,0,1
Kenwood Petroleum Corp.,0,0,1,0,0,1
Kerben Oil Co.,0,0,1,0,0,1
Kerman Syndicate,0,0,1,0,0,1
Kern-Puchea Oil Co.,0,0,1,0,0,1
Kern 29 Oil Co.,0,0,1,0,0,1
Kern County Land Company,0,0,1,0,0,1
Kern County Parks & Rec. Dept.,0,0,1,0,0,1
Kern Drilling Co.,0,0,1,0,0,1
Kern Sunset Oil Co.,0,0,1,0,0,1
Kern Torrance Petroleum Co.,0,0,1,0,0,1
Kern Trading & Oil Co.,0,0,1,0,0,1
Kernel Oil Co.,0,0,1,0,0,1
Kernex Oil Co.,0,0,1,0,0,1
Kernridge Oil Company,0,0,1,0,0,1
Kerr Brothers,0,0,1,0,0,1
Kerry Oil Co.,0,0,1,0,0,1
Kesson & Jones,0,0,1,0,0,1
Kettleman View Oil & Gas Co.,0,0,1,0,0,1
Keystone Petro. Corp.,0,0,1,0,0,1
Keystone Western Oil Co.,0,0,1,0,0,1
Kimberley Exploration Co.,0,0,1,0,0,1
King-McCray Oil Co.,0,0,1,0,0,1
King & Marris,0,0,1,0,0,1
King G. Gillette,0,0,1,0,0,1
King George Oil Co.,0,0,1,0,0,1
"King Oil, Inc.",0,0,1,0,0,1
Kings County Oil Co.,0,0,1,0,0,1
Kings Expl. Co.,0,0,1,0,0,1
Kings River Oil Pool,0,0,1,0,0,1
Kingsburg Exploration Co.,0,0,1,0,0,1
Kinlaw Oil Corp.,0,0,1,0,0,1
Kirk Oil Co.,0,0,1,0,0,1
Kittie C. Bailard,0,0,1,0,0,1
Klamath Expl.,0,0,1,0,0,1
Klaner & Doolin,0,0,1,0,0,1
Klondike Petroleum Co.,0,0,1,0,0,1
"Knickerbocker Oil Co., Ltd.",0,0,1,0,0,1
Knieper and Atha,0,0,1,0,0,1
Knight & Miller Oil Corp.,0,0,1,0,0,1
Knight Oil Co.,0,0,1,0,0,1
Knudsen-Schmidt Co.,0,0,1,0,0,1
Koble Energy,0,0,1,0,0,1
Koch Oil Company,0,0,1,0,0,1
Kohlbush & Campbell,0,0,1,0,0,1
Kovaleski-Gwynne,0,0,1,0,0,1
Kraemer Estate,0,0,1,0,0,1
Kramildon Oil Co.,0,0,1,0,0,1
Kyle & Lewis,0,0,1,0,0,1
Kyrtle Bailard,0,0,1,0,0,1
L & B Oil Co.,0,0,1,0,0,1
L & B Producing and Drilling Co.,0,0,1,0,0,1
L & D Enterprises,0,0,1,0,0,1
"L & M Oil Co., Inc.",0,0,1,0,0,1
"L. A.-Madera Syn. Rex Goodcell, Trustee",0,0,1,0,0,1
L. A. & Kern Oil Mining Co.,0,0,1,0,0,1
L. A. Basin Oil Co.,0,0,1,0,0,1
"L. A. Hanson, Sr.",0,0,1,0,0,1
L. A. Harnish,0,0,1,0,0,1
L. A. Lambert Oil Synd. #2,0,0,1,0,0,1
L. A. Thomson and A. A. Rembold,0,0,1,0,0,1
L. A. Ventura Oil Fields Co.,0,0,1,0,0,1
"L. B. Armstrong, Oper.",0,0,1,0,0,1
L. C. Main,0,0,1,0,0,1
L. E. Bishop Oil Co.,0,0,1,0,0,1
L. E. Broadhurst,0,0,1,0,0,1
L. E. Doan,0,0,1,0,0,1
L. E. Ellington,0,0,1,0,0,1
L. E. Kesselman,0,0,1,0,0,1
L. E. Schultz,0,0,1,0,0,1
L. E. Stokes,0,0,1,0,0,1
L. E. Swanson,0,0,1,0,0,1
L. G. Larson Drilling Co.,0,0,1,0,0,1
L. G. Miller,0,0,1,0,0,1
L. G. Wright,0,0,1,0,0,1
L. H. Dodge,0,0,1,0,0,1
L. H. Judson & J. C. McCollum,0,0,1,0,0,1
L. H. Mitchel & Sons,0,0,1,0,0,1
L. H. Scott,0,0,1,0,0,1
"L. Harry Barnett, Oper.",0,0,1,0,0,1
L. J. F. Bremmer,0,0,1,0,0,1
L. L. Robertson and R. S. Moore,0,0,1,0,0,1
L. M. Hampton,0,0,1,0,0,1
L. O. Tarrant,0,0,1,0,0,1
L. P. Beer,0,0,1,0,0,1
L. R. Wahl,0,0,1,0,0,1
L. R. Wilhite & Claude Kavanaugh,0,0,1,0,0,1
L. S. Bowen & H J Bowen,0,0,1,0,0,1
L. T. Oglesby,0,0,1,0,0,1
L. V. Wilson,0,0,1,0,0,1
L. W. Frankley-Dwight G. Vedder,0,0,1,0,0,1
L. W. Gibson,0,0,1,0,0,1
L. W. Harrison,0,0,1,0,0,1
"L. W. Herman, Receiver for Max Pray",0,0,1,0,0,1
L. W. S. Co.,0,0,1,0,0,1
"L. W. S. Oil Co., Ltd.",0,0,1,0,0,1
L.M.S. Oil Co.,0,0,1,0,0,1
"La Bara Oil Co. (R. B. Seymour, Trustee)",0,0,1,0,0,1
La Barat Syndicate,0,0,1,0,0,1
La Boa Expl. Co.,0,0,1,0,0,1
La Bolsa Rancho Syndicate,0,0,1,0,0,1
La Habra Midway Oil Co.,0,0,1,0,0,1
La Honda Fields Limited Partnership,0,0,1,0,0,1
La Honda Oil & Gas Co.,0,0,1,0,0,1
La Jolla Petro. Co.,0,0,1,0,0,1
LA Land Co.,0,0,1,0,0,1
La Mesa Oil Co.,0,0,1,0,0,1
La Rita Oil Co.,0,0,1,0,0,1
"Lacy, McLachlen & Lacy",0,0,1,0,0,1
"Ladd Canyon Expl., Inc.",0,0,1,0,0,1
Ladden Oil Co.,0,0,1,0,0,1
"Ladenburg, Thalman & Co.",0,0,1,0,0,1
Lafayette Oil Co.,0,0,1,0,0,1
Lafayette Petro. Corp.,0,0,1,0,0,1
Lago Vista Oil Co.,0,0,1,0,0,1
"Lakern Oil Company, Inc.",0,0,1,0,0,1
"Lakern Petroleum Corp., Ltd.",0,0,1,0,0,1
Lamaro Petroleum Co.,0,0,1,0,0,1
Lamb Exploration Co. & Greathouse Oil Co.,0,0,1,0,0,1
Lambert Hampton Oil Synd. No.1,0,0,1,0,0,1
Lammerts Oil Company,0,0,1,0,0,1
Lance Fletcher,0,0,1,0,0,1
Landess Oil Co.,0,0,1,0,0,1
Lane-Wells Co.,0,0,1,0,0,1
Lang Well No. 5,0,0,1,0,0,1
Lange Oil Co. of Texas,0,0,1,0,0,1
Lanoie Dresden,0,0,1,0,0,1
Lantex Oil Co.,0,0,1,0,0,1
Larco Oil Co.,0,0,1,0,0,1
Larsen Oil Co.,0,0,1,0,0,1
Las Cruces Oil Co.,0,0,1,0,0,1
Las Flores Dev.,0,0,1,0,0,1
Las Palmas Petro. Co.,0,0,1,0,0,1
Last Chance Petroleum Co.,0,0,1,0,0,1
Lawndale Expl. Co.,0,0,1,0,0,1
Lawrence A. Thomson. Jr.,0,0,1,0,0,1
"Lawrence Barker, Jr. & Roy Naftzger, Jr.",0,0,1,0,0,1
"Lawrence P. Reischman, Opr.",0,0,1,0,0,1
LCT Equipment Inc.,0,0,1,0,0,1
Le Grand Syndicate,0,0,1,0,0,1
Lebow-Harbor Oil Co.,0,0,1,0,0,1
Lebow-Von Glahn,0,0,1,0,0,1
Lebow Fresno Oil Co.,0,0,1,0,0,1
Lebow Petro. Co.,0,0,1,0,0,1
Lee and Jane Laird,0,0,1,0,0,1
Lee Grumbaugh,0,0,1,0,0,1
Lee Oil Co. Ltd,0,0,1,0,0,1
Lee Salter,0,0,1,0,0,1
Lee Sievers,0,0,1,0,0,1
"Leingang Oil Expl., Inc.",0,0,1,0,0,1
Len Owens & J. Dewitt Expl. Co.,0,0,1,0,0,1
Lennox Petro. Co.,0,0,1,0,0,1
Leo H. Moir Jr.,0,0,1,0,0,1
Leonard A. Gregory,0,0,1,0,0,1
Leonard A. Gwynne & Assoc.,0,0,1,0,0,1
Leonard Brothers,0,0,1,0,0,1
Leonard O. Lindborg,0,0,1,0,0,1
Leonard P. Remley,0,0,1,0,0,1
"Leroy C. Gould, Operator",0,0,1,0,0,1
Leroy Titherington & Richard L. Herndon,0,0,1,0,0,1
Les-Cal Co. & J. W. Wood,0,0,1,0,0,1
Les Miller,0,0,1,0,0,1
Lesco Corp.,0,0,1,0,0,1
Lesco Oil Corp.,0,0,1,0,0,1
"Lesher Oil Co., Unit No. 1",0,0,1,0,0,1
"Lesher Oil Co., Unit No. 2",0,0,1,0,0,1
Leslie B. Riggins,0,0,1,0,0,1
Leslie D. Vaughn & Assoc.,0,0,1,0,0,1
"Less-Cal Co. & J.W. Wood, Oper.",0,0,1,0,0,1
Lester K. Surgener and Robert B. Doe,0,0,1,0,0,1
Lewis Guerrieri,0,0,1,0,0,1
Lewis Petroleum Co.,0,0,1,0,0,1
Lex Oil Co.,0,0,1,0,0,1
Libco Petroleum Co.,0,0,1,0,0,1
Lillian B. Robinett et al,0,0,1,0,0,1
Lillian B. Schmidt,0,0,1,0,0,1
Linc-Con Oil Operating Co.,0,0,1,0,0,1
Lincoln & Kuhns,0,0,1,0,0,1
"Lincoln Petroleum Corp., Ltd.",0,0,1,0,0,1
Lindsay Petro. Co.,0,0,1,0,0,1
Link Trucking Co.,0,0,1,0,0,1
Lion Oil & Gas Company LLC,0,0,1,0,0,1
LIT Industrial Limited Partnership,0,0,1,0,0,1
Litho Oil Co.,0,0,1,0,0,1
Little Bear Oil Company,0,0,1,0,0,1
Little Chief Oil Co.,0,0,1,0,0,1
Little Four Limited,0,0,1,0,0,1
"Little Jewel, LLC",0,0,1,0,0,1
Little Major Oil Co.,0,0,1,0,0,1
Little Oil Well Co.,0,0,1,0,0,1
Little Pluto,0,0,1,0,0,1
"Live Oak Oil Co., Ltd.",0,0,1,0,0,1
Livingston Drilling & Dev. Co.,0,0,1,0,0,1
Lloyd A. Harnish Assoc.,0,0,1,0,0,1
Lloyd Harnish Associates,0,0,1,0,0,1
Lloyd Manning,0,0,1,0,0,1
Locust Oil Co.,0,0,1,0,0,1
Lodi Farms L.P.,0,0,1,0,0,1
Lodico Oil Co.,0,0,1,0,0,1
Loffland Brothers Co.,0,0,1,0,0,1
Loma Grande Oil Co.,0,0,1,0,0,1
Loma Verde Oil Co.,0,0,1,0,0,1
Loma Verde Petro. Co.,0,0,1,0,0,1
Lomita Oil Well Service Co.,0,0,1,0,0,1
"Lon W. Raley, Trustee",0,0,1,0,0,1
"Lone Eagle, LLC",0,0,1,0,0,1
Lone Mountain Prod. Co.,0,0,1,0,0,1
Lone Star Oil Syndicate,0,0,1,0,0,1
"Lonestar Foundation, Inc.",0,0,1,0,0,1
Long-Mizel & Assoc.,0,0,1,0,0,1
Long and Associates,0,0,1,0,0,1
Long Beach Oil Operators,0,0,1,0,0,1
Lori Exploration Co.,0,0,1,0,0,1
Lorraine Oil Co.,0,0,1,0,0,1
Los Angeles-McKittrick Oil Co.,0,0,1,0,0,1
Los Angeles Brewing Co.,0,0,1,0,0,1
Los Angeles Coalinga Oil Syndicate,0,0,1,0,0,1
Los Angeles County Metropolitan Transportation Authority,0,0,1,0,0,1
Los Angeles M.,0,0,1,0,0,1
Los Angeles Midway Oil Co.,0,0,1,0,0,1
Los Angeles Oil Co.,0,0,1,0,0,1
Los Angeles Ventura Oil Co.,0,0,1,0,0,1
Los Banos Oil Co.,0,0,1,0,0,1
Los Chicos Oil Co.,0,0,1,0,0,1
Los Chinos Oil Co.,0,0,1,0,0,1
Los Feliz Co.,0,0,1,0,0,1
Los Gatos Creek Dev. Co.,0,0,1,0,0,1
Los Gatos Oil Co. Ltd,0,0,1,0,0,1
Los Nietos Oil Co.,0,0,1,0,0,1
"Los Nietos Producing and Refining Co., Ltd.",0,0,1,0,0,1
Los Nietos Valley Oil Co.,0,0,1,0,0,1
Los Posas Petro. Corp.,0,0,1,0,0,1
Louie E. Bannow,0,0,1,0,0,1
Louis B O'neil,0,0,1,0,0,1
Louis Benjamin Altchuler,0,0,1,0,0,1
Louis Cass Jr,0,0,1,0,0,1
Louis D. Fay,0,0,1,0,0,1
Louis Erlich,0,0,1,0,0,1
Louis H. Scott,0,0,1,0,0,1
Louis Lucier,0,0,1,0,0,1
Louis Mattis,0,0,1,0,0,1
"Louis Mattis, Oper.",0,0,1,0,0,1
Louis Melczer,0,0,1,0,0,1
Louis Titus Oil Co.,0,0,1,0,0,1
Louise H. Didier,0,0,1,0,0,1
Lovelady and Christman,0,0,1,0,0,1
Lovelady Supply Co. and L. L. Robertson,0,0,1,0,0,1
Lovely Petro. Co.,0,0,1,0,0,1
Lovoda E. Ralph,0,0,1,0,0,1
Lowry Hydraulic Co. Inc.,0,0,1,0,0,1
Loyal Resources Corp.,0,0,1,0,0,1
Loyd Wright,0,0,1,0,0,1
Lube Oil Company,0,0,1,0,0,1
Lucerne Oil Co.,0,0,1,0,0,1
Lucien M. Higgnis,0,0,1,0,0,1
Lucille A. Jackson,0,0,1,0,0,1
Luck Oil Co.,0,0,1,0,0,1
"Lucky Strike Oil Co., Ltd.",0,0,1,0,0,1
Lyman C. Hisey,0,0,1,0,0,1
Lyman Investment Co.,0,0,1,0,0,1
Lyndon & DeSpain,0,0,1,0,0,1
Lyon & Bassett,0,0,1,0,0,1
M-C-A Drilling Co.,0,0,1,0,0,1
"M-K Development & Investment, Inc.",0,0,1,0,0,1
M & M Oil & Gas Corporation,0,0,1,0,0,1
M & W Oil Co.,0,0,1,0,0,1
"M and A Oil Co., Ltd.",0,0,1,0,0,1
M and S Oil Co.,0,0,1,0,0,1
M B Z Productions,0,0,1,0,0,1
M. A. Bernhard,0,0,1,0,0,1
M. A. Cox,0,0,1,0,0,1
M. A. McFadden,0,0,1,0,0,1
"M. B. Daly, Jr.",0,0,1,0,0,1
M. B. Wilcox,0,0,1,0,0,1
M. C. Albertson Oil Co.,0,0,1,0,0,1
M. C. M. O. & Asso.,0,0,1,0,0,1
M. C. O. & Asso.,0,0,1,0,0,1
M. C. Peebles & D D Peebles,0,0,1,0,0,1
"M. C. R. R. Co., Ltd.",0,0,1,0,0,1
M. E. Frazier,0,0,1,0,0,1
"M. E. Frazier, Oper.",0,0,1,0,0,1
M. F. Van Horn,0,0,1,0,0,1
M. F. Van Horn Opr,0,0,1,0,0,1
M. Frazier,0,0,1,0,0,1
M. H. Stone,0,0,1,0,0,1
M. H. Whittier Energy LLC,0,0,1,0,0,1
M. I. Lebow and Coalinga Drlg. Co.,0,0,1,0,0,1
"M. I. Lebow, Oper.",0,0,1,0,0,1
M. J. Graves,0,0,1,0,0,1
M. J. Pettijohn,0,0,1,0,0,1
M. J. Stansbury & Assoc.,0,0,1,0,0,1
M. K. & T. Oil Co.,0,0,1,0,0,1
M. K. F. Oil Co.,0,0,1,0,0,1
M. L. Gillespie,0,0,1,0,0,1
"M. L. Jenkins Production, Inc.",0,0,1,0,0,1
M. M. Harris,0,0,1,0,0,1
M. M. Humphries,0,0,1,0,0,1
M. O. C. Oil Co.,0,0,1,0,0,1
M. P. Oil,0,0,1,0,0,1
M. P. Shepherd,0,0,1,0,0,1
M. R. Peck,0,0,1,0,0,1
M. R. Yant,0,0,1,0,0,1
M. T. M. Associates,0,0,1,0,0,1
M. W. Stevenson,0,0,1,0,0,1
M. Z. Elliott,0,0,1,0,0,1
M.A.B. Oil Co.,0,0,1,0,0,1
M.C.R. Oil Recovery International Inc.,0,0,1,0,0,1
M.J.B. Oil Co.,0,0,1,0,0,1
M.J.S. Oil Company,0,0,1,0,0,1
M/S & Assoc.,0,0,1,0,0,1
Mabel E. French,0,0,1,0,0,1
Mac-Vee Associates,0,0,1,0,0,1
Mac Oil Co.,0,0,1,0,0,1
Macalene Oil Co.,0,0,1,0,0,1
Macco Corp.,0,0,1,0,0,1
MacDonald & Norris,0,0,1,0,0,1
"MacDonald, Burns & Norris #4",0,0,1,0,0,1
Mace A. Cox,0,0,1,0,0,1
"MacGregor Oil Co., Inc.",0,0,1,0,0,1
Macklin Oil Co.,0,0,1,0,0,1
"Macrate Oil Co. & G. E. Miller, Opers",0,0,1,0,0,1
"Macrate Oil Co., Oper.",0,0,1,0,0,1
Madera Oil & Gas,0,0,1,0,0,1
Madonna Construction Co.,0,0,1,0,0,1
"Magellan El Monte, LLC",0,0,1,0,0,1
"Magma Energy, Inc.",0,0,1,0,0,1
Magma Oil Co.,0,0,1,0,0,1
Magnolia Petro. Syndicate No. 1,0,0,1,0,0,1
"Magu Syndicate Inc., Ltd",0,0,1,0,0,1
Maier-Yerkes Syndicate,0,0,1,0,0,1
Major Oil Co.,0,0,1,0,0,1
Mal-al Oil Co.,0,0,1,0,0,1
"Malibu Signal Oil Co., Ltd.",0,0,1,0,0,1
Manchester Oil Co.,0,0,1,0,0,1
Manco Prod.,0,0,1,0,0,1
"Mangold and Morse Oil Co., Inc.",0,0,1,0,0,1
Mangrum & Page,0,0,1,0,0,1
Manhattan Pacific Oil Co.,0,0,1,0,0,1
Manila D. Gatzman,0,0,1,0,0,1
Manitou Oil Co.,0,0,1,0,0,1
Maplehurst Oil Co.,0,0,1,0,0,1
Mar Vena Oil Co.,0,0,1,0,0,1
"Maralex Resources, Inc.",0,0,1,0,0,1
Marblehead Land Co.,0,0,1,0,0,1
Marcan Oil Co.,0,0,1,0,0,1
Marcell Oil & Gas Corp.,0,0,1,0,0,1
March Oil Co.,0,0,1,0,0,1
Marcus E. Skeen,0,0,1,0,0,1
Marfar Oil Co.,0,0,1,0,0,1
Margaret H. Fairchild,0,0,1,0,0,1
Margaret L. Slaughter,0,0,1,0,0,1
Margaret W. Colvin,0,0,1,0,0,1
Marian L Reynolds,0,0,1,0,0,1
Maricopa Visalia Oil Co.,0,0,1,0,0,1
Marine Corp.-Western Corp.,0,0,1,0,0,1
Marion H. B. Oil Co.,0,0,1,0,0,1
Mark Downing,0,0,1,0,0,1
Mark Y. and Mary Anne Hite,0,0,1,0,0,1
Marland Co.,0,0,1,0,0,1
Marland Oil Co.,0,0,1,0,0,1
Marlex Petroleum Inc.,0,0,1,0,0,1
Marline Oil Corp.,0,0,1,0,0,1
Martin Judge Jr.,0,0,1,0,0,1
Martin O. Landers,0,0,1,0,0,1
Martin Oil Co.,0,0,1,0,0,1
Martin Petroleum Co.,0,0,1,0,0,1
Mary Angela Oil Co.,0,0,1,0,0,1
Mary B. Hall,0,0,1,0,0,1
Mary E. Connolly,0,0,1,0,0,1
Mary E. Wertalla,0,0,1,0,0,1
Mascot Oil Company,0,0,1,0,0,1
Master Petroleum Corp.,0,0,1,0,0,1
Matador Oil Co.,0,0,1,0,0,1
Matilija Oil Co.,0,0,1,0,0,1
Matris Exploration Company,0,0,1,0,0,1
Mattole Oil Co.,0,0,1,0,0,1
Maude C. Ltd.,0,0,1,0,0,1
"Max C. Eastman, Oper.",0,0,1,0,0,1
Maxwell & Associates,0,0,1,0,0,1
Maxwell Oil Co.,0,0,1,0,0,1
May Drilling Co.,0,0,1,0,0,1
Mayo-Fourl Oil Co.,0,0,1,0,0,1
McAdams Expl. Co.,0,0,1,0,0,1
McAdams Oil Syndicate,0,0,1,0,0,1
McAdams Petroleum Corp.,0,0,1,0,0,1
McBurney and Mead,0,0,1,0,0,1
McCallen & Derigo,0,0,1,0,0,1
McCallen Realty Syndicate,0,0,1,0,0,1
McClanahan Oil Co.,0,0,1,0,0,1
McCreary & Walton,0,0,1,0,0,1
McDonald & Brenton,0,0,1,0,0,1
McDonald Drilling Co.,0,0,1,0,0,1
"McDonald Petro., Ltd.",0,0,1,0,0,1
"McDonald, Burns and Norris No. 6",0,0,1,0,0,1
"McFaddin, McDowell & Bering",0,0,1,0,0,1
McFann Drilling Co.,0,0,1,0,0,1
McFarland Oil Syndicate,0,0,1,0,0,1
McGill & Shepard Expl. & Dev.,0,0,1,0,0,1
McGreevy-Neary Oil Company,0,0,1,0,0,1
McGreevy & Neary,0,0,1,0,0,1
McK. Butler & Associates,0,0,1,0,0,1
McKay-Brinkman Oil Company,0,0,1,0,0,1
McKee-Bramham-Lonn Co.,0,0,1,0,0,1
McKee Oil Co.,0,0,1,0,0,1
McKenzie-Hazard Syndicate,0,0,1,0,0,1
McKenzie & Assoc.,0,0,1,0,0,1
McKittrick Chief Oil Co.,0,0,1,0,0,1
McNee Oil Co. and Assoc.,0,0,1,0,0,1
McQueen-Whalen Revocable Trust,0,0,1,0,0,1
McQuigg Investment Co.,0,0,1,0,0,1
McVicar-Rood-Hall,0,0,1,0,0,1
McVicar Rood and Cole Co.,0,0,1,0,0,1
McVicker Sailee Dev. Co.,0,0,1,0,0,1
"MDR Hotels, LLC",0,0,1,0,0,1
Medallion Oil Co.,0,0,1,0,0,1
Meeker-Garner Oil Co.,0,0,1,0,0,1
"Meier Oil Co., Ltd.",0,0,1,0,0,1
Mel-Cann Inc.,0,0,1,0,0,1
Memphis Oil Co.,0,0,1,0,0,1
Merced Oil Co.,0,0,1,0,0,1
Merced Paraffine Oil Co.,0,0,1,0,0,1
Merchants & Traders,0,0,1,0,0,1
"Mercury Oil Corp., Inc.",0,0,1,0,0,1
Meridian Oil,0,0,1,0,0,1
Meridian Oil Company,0,0,1,0,0,1
"Meridian Oil Company, Ltd.",0,0,1,0,0,1
Merle Cade,0,0,1,0,0,1
Merle W Wheeler,0,0,1,0,0,1
Merrill Salvage Co.,0,0,1,0,0,1
Mervin E Mallett,0,0,1,0,0,1
Mesa Oil Co.,0,0,1,0,0,1
Mesa Petroleum Co.,0,0,1,0,0,1
Mescalitan Island Oil and Development Co.,0,0,1,0,0,1
Metric Exploration,0,0,1,0,0,1
Metropolitan Oil Co.,0,0,1,0,0,1
Meyer-Bassett-Rorex Co.,0,0,1,0,0,1
Michael Abraham,0,0,1,0,0,1
Michael J. Major,0,0,1,0,0,1
Michael Kadlec,0,0,1,0,0,1
Michel T. Halbouty,0,0,1,0,0,1
Mickelson Oil & Gas,0,0,1,0,0,1
Mid-Cal Oil & Gas Co.,0,0,1,0,0,1
Mid-Central Oil Co.,0,0,1,0,0,1
Mid-Cities Oil Co.,0,0,1,0,0,1
"Mid-Kettleman Oil Co., Inc.",0,0,1,0,0,1
Mid-State Petroleum Co.,0,0,1,0,0,1
Midas Oil,0,0,1,0,0,1
Midcoast Oil Co,0,0,1,0,0,1
Midfield Corp.,0,0,1,0,0,1
Midfield Oil Co.,0,0,1,0,0,1
"Midland Overseas, Inc.",0,0,1,0,0,1
Midland Petro. Co.,0,0,1,0,0,1
Midvalley Corporation,0,0,1,0,0,1
Midway Alliance,0,0,1,0,0,1
Midway Drilling Co.,0,0,1,0,0,1
Midway Gas Co.,0,0,1,0,0,1
Midway Peak Oil Co.,0,0,1,0,0,1
Midway Premier Oil Company,0,0,1,0,0,1
Midway Simi,0,0,1,0,0,1
Midway Supply Co.,0,0,1,0,0,1
"Miesse, Hemphill & Rown",0,0,1,0,0,1
Migs Oil Co.,0,0,1,0,0,1
Mihlheim Oil Co.,0,0,1,0,0,1
Miken Oil & Gas Co.,0,0,1,0,0,1
Milburn & Hamilton,0,0,1,0,0,1
Miles Andrews,0,0,1,0,0,1
Miles Production Co.,0,0,1,0,0,1
Miller & Sullivan,0,0,1,0,0,1
Miller & Weaver,0,0,1,0,0,1
Miller and Nicolai,0,0,1,0,0,1
Miller and York and R. M. Claire,0,0,1,0,0,1
Miller Oil Operations,0,0,1,0,0,1
Millerand Petro. Co.,0,0,1,0,0,1
Millhar Assoc.,0,0,1,0,0,1
Milnen Oil Co.,0,0,1,0,0,1
Milo Oil Co.,0,0,1,0,0,1
Milpet Co.,0,0,1,0,0,1
Milroy Oil Co. Inc.,0,0,1,0,0,1
Milton M. Unger,0,0,1,0,0,1
Milton Mende,0,0,1,0,0,1
Milton N. Thompson,0,0,1,0,0,1
Minerals & Petro. Dev. Corp.,0,0,1,0,0,1
Minnesota Oil Co.,0,0,1,0,0,1
Mission Hills Oil Co.,0,0,1,0,0,1
"Mission Oil Co., Operator",0,0,1,0,0,1
Mission Oil Corp.,0,0,1,0,0,1
Mitchell and Terry,0,0,1,0,0,1
"Mitchwil Investments, LLC",0,0,1,0,0,1
Mobil Oil Corp.,0,0,1,0,0,1
Moffatt & Campbell Petro. Co. Ltd.,0,0,1,0,0,1
Mohawk Petroleum Corp. & Atlantic Oil Co.,0,0,1,0,0,1
Mojave Basin Oil Co.,0,0,1,0,0,1
Mojave Oil Co.,0,0,1,0,0,1
Mojave River Oil Corp.,0,0,1,0,0,1
Monarch Oil Corp.,0,0,1,0,0,1
Monitor,0,0,1,0,0,1
Monroe-Baer Oil Co.,0,0,1,0,0,1
Monroe & Granger,0,0,1,0,0,1
Monte Cristo Petro. Co.,0,0,1,0,0,1
Montebello Crude Oil Co.,0,0,1,0,0,1
Montebello Reservoir Oil Co.,0,0,1,0,0,1
Montebello Wesco Inc.,0,0,1,0,0,1
Montecito Oil Producers Co.,0,0,1,0,0,1
Montello Oil Co. Ltd.,0,0,1,0,0,1
Monterey Bay Oil Co. Ltd,0,0,1,0,0,1
Monterey Exploration Co.,0,0,1,0,0,1
Monterey Park Land co.,0,0,1,0,0,1
Monterey Peninsula Oil Co.,0,0,1,0,0,1
"Monticello Oil Co., Ltd.",0,0,1,0,0,1
Mooschekian Bros.,0,0,1,0,0,1
Morey E. Hall,0,0,1,0,0,1
Morgan and Harris,0,0,1,0,0,1
Morgan Gas & Oil Explor. Co.,0,0,1,0,0,1
Mormac Oil & Mining Co.,0,0,1,0,0,1
"Morrell's Electro-Plating, Inc.",0,0,1,0,0,1
Morris B. Marks,0,0,1,0,0,1
Morris Berman and Associates,0,0,1,0,0,1
Morton L. Brown,0,0,1,0,0,1
"Morton N. D'Evelyn, Operator",0,0,1,0,0,1
Morton S. Martin,0,0,1,0,0,1
Mosebach Oil Co.,0,0,1,0,0,1
Moss & Walker,0,0,1,0,0,1
"Mount Poso Dowsers, Inc.",0,0,1,0,0,1
Mrs. A.M. Hoeppner,0,0,1,0,0,1
Mrs. Germanina Truano,0,0,1,0,0,1
Mrs. Helen A. Meyer,0,0,1,0,0,1
Mrs. Pearl M. Phelps,0,0,1,0,0,1
Mse Operating Corp.,0,0,1,0,0,1
Mt. Vernon,0,0,1,0,0,1
Mulholland Oil Co.,0,0,1,0,0,1
"Mullins Oil, Inc.",0,0,1,0,0,1
Murdock Oil Co.,0,0,1,0,0,1
Murietta Valley,0,0,1,0,0,1
Muroc Dev. Co.,0,0,1,0,0,1
"Musco Olive Products, Inc.",0,0,1,0,0,1
Mutual Dev. Assoc.,0,0,1,0,0,1
Mutual Oil Co.,0,0,1,0,0,1
Myers & Wilhite,0,0,1,0,0,1
Myron T. King,0,0,1,0,0,1
N-H Co.,0,0,1,0,0,1
N-W Oil & Gas,0,0,1,0,0,1
N & G Well Servicing Co.,0,0,1,0,0,1
N Y K Oil Co.,0,0,1,0,0,1
N. B. & M. Oil Co.,0,0,1,0,0,1
N. B. Hunt,0,0,1,0,0,1
N. D. Bradford & J. F. Guardino,0,0,1,0,0,1
N. F. C. Petro. Corp.,0,0,1,0,0,1
N. F. Keyt,0,0,1,0,0,1
N. M. Fraser,0,0,1,0,0,1
N. M. McCormick and E. V. Pratt,0,0,1,0,0,1
N. O. Shively,0,0,1,0,0,1
N. P. Van Valkenburgh,0,0,1,0,0,1
N. S. Mitchell,0,0,1,0,0,1
N. S. Wilson,0,0,1,0,0,1
Nacimiento Oil Co.,0,0,1,0,0,1
Naftex Holdings Limited,0,0,1,0,0,1
Nathan Short,0,0,1,0,0,1
National Driling & Dev. Co.,0,0,1,0,0,1
"National Investors Fund, Inc.",0,0,1,0,0,1
"National Iron Works, Oil Division",0,0,1,0,0,1
"National Oil & Gas, Inc.",0,0,1,0,0,1
"National Oil Works, Oil Division",0,0,1,0,0,1
"National Petro. Consultants, Ltd.",0,0,1,0,0,1
National Securities Oil Co.,0,0,1,0,0,1
National Steel and Shipbuilding Corp.,0,0,1,0,0,1
Natomas N. America Inc.,0,0,1,0,0,1
Natural Gasoline Company,0,0,1,0,0,1
Natural Res. Investment Corp.,0,0,1,0,0,1
Navitas Oil & Gas LLC,0,0,1,0,0,1
"NB Resources (California), Inc.",0,0,1,0,0,1
Ne-Tex Corp.,0,0,1,0,0,1
Neal H. Anderson,0,0,1,0,0,1
Neal Stivers,0,0,1,0,0,1
Nealy Exploration Co.,0,0,1,0,0,1
"Ned Barmore, Oper.",0,0,1,0,0,1
Nelco Oil Corp.,0,0,1,0,0,1
Nels A. Madsen,0,0,1,0,0,1
Nelson-Merlo,0,0,1,0,0,1
Nelson G. Smith,0,0,1,0,0,1
Nelson J Hansen & Co.,0,0,1,0,0,1
"Nelson Petro. Co., Ltd. Tyler, Rec.",0,0,1,0,0,1
Neon Energy Corporation,0,0,1,0,0,1
"Nepture Oil Co., Ltd",0,0,1,0,0,1
Neutron Resources,0,0,1,0,0,1
"Nev-Tex Oil & Gas, Inc.",0,0,1,0,0,1
Neva Oil Co.,0,0,1,0,0,1
Nevaco Oil & Gas,0,0,1,0,0,1
Nevada Drilling Co.,0,0,1,0,0,1
"Nevada Exploration, Inc.",0,0,1,0,0,1
Nevada Pacific,0,0,1,0,0,1
New Bedford,0,0,1,0,0,1
New Hope Oil Co.,0,0,1,0,0,1
New York Oil Co.,0,0,1,0,0,1
"Newbury 15 Group, LLC",0,0,1,0,0,1
Newell Oil Co.,0,0,1,0,0,1
Newhall Consolidated Oil Co,0,0,1,0,0,1
Newhall Land & Farming Co.,0,0,1,0,0,1
Newhall Refining Co. Inc.,0,0,1,0,0,1
Newman-Morris Oil & Land Co.,0,0,1,0,0,1
Newpet Oil Co.,0,0,1,0,0,1
Newton Drilling Co. Inc. Op,0,0,1,0,0,1
Nhd Oil & Gas Co.,0,0,1,0,0,1
Nick & Martin Lopin & F. Bever,0,0,1,0,0,1
"Nick Gerard Oil Company, Ltd.",0,0,1,0,0,1
Nick L. Notterman,0,0,1,0,0,1
Nine Springs Oil Co.,0,0,1,0,0,1
NishPaul Oil Co.,0,0,1,0,0,1
Noah S Andrews,0,0,1,0,0,1
Noble H. Wible,0,0,1,0,0,1
Noble Oil Co.,0,0,1,0,0,1
Nordon Oil Corporation,0,0,1,0,0,1
Norman & Marie A Schmidt,0,0,1,0,0,1
Norman MacDonald,0,0,1,0,0,1
Norman P. Miller,0,0,1,0,0,1
Norris Road Venture,0,0,1,0,0,1
North Basin Expl. Corp.,0,0,1,0,0,1
North Central Oil Corp.,0,0,1,0,0,1
North Counties Dev. Co.,0,0,1,0,0,1
North Elk Oil,0,0,1,0,0,1
"North Kern Front Enterprises, Inc.",0,0,1,0,0,1
North Kern Oil Co.,0,0,1,0,0,1
North Star Gas Co.,0,0,1,0,0,1
North West Cuyama Oil Co.,0,0,1,0,0,1
Northern California Power Agency,0,0,1,0,0,1
Northern Consolidated Oil Co.,0,0,1,0,0,1
Northern Counties Petroleum Co.,0,0,1,0,0,1
Northern Oil & Gas Co.,0,0,1,0,0,1
Northlode Expl. Ltd.,0,0,1,0,0,1
Notre Dame Petroleum Company,0,0,1,0,0,1
NRM Petroleum Corporation,0,0,1,0,0,1
Nuevo Camulas Oil Co.,0,0,1,0,0,1
Nuevo Oil Co.,0,0,1,0,0,1
Nugent Driling Co.,0,0,1,0,0,1
Nuoil Co.,0,0,1,0,0,1
Nuwi-Bayshore LLC,0,0,1,0,0,1
O'Brien & Webber,0,0,1,0,0,1
O'Meara & Rogers Construction Co.,0,0,1,0,0,1
"O'Meara, Rogers & Siemon",0,0,1,0,0,1
O'Quinn & Hadley,0,0,1,0,0,1
O. & S. Oil Co.,0,0,1,0,0,1
"O. Biller, Oper.",0,0,1,0,0,1
"O. E. Mankin, C. H. Johnson, Emil A. J.",0,0,1,0,0,1
"O. F. W. Drilling Co., Inc.",0,0,1,0,0,1
O. G. Green,0,0,1,0,0,1
"O. H. Calhoun, Operator",0,0,1,0,0,1
O. H. Crabtree & Estate of R. F. Zingg,0,0,1,0,0,1
O. H. Griggs & Claude C. Sumter,0,0,1,0,0,1
O. K. Hearte,0,0,1,0,0,1
O. K. Hearte and Trace Harkness,0,0,1,0,0,1
O. L. Bolton Co.,0,0,1,0,0,1
"O. M. Slosson, Operator",0,0,1,0,0,1
O. R. Howard,0,0,1,0,0,1
O. R. Sickler,0,0,1,0,0,1
"Oak Room, Inc.",0,0,1,0,0,1
"Oakdale Oil Corp., Ltd.",0,0,1,0,0,1
Oakland-McKittrick Oil,0,0,1,0,0,1
Oakmont Petro. Syndicate,0,0,1,0,0,1
Oasis Oil Company,0,0,1,0,0,1
Obispo Oil Co. & Brookshire Oil Co.,0,0,1,0,0,1
Odell Petro. Corp.,0,0,1,0,0,1
Off & Campbell,0,0,1,0,0,1
Ohro Oil Co.,0,0,1,0,0,1
Oil Center Consolidated,0,0,1,0,0,1
Oil Dev. Corp.,0,0,1,0,0,1
"Oil Factors, Inc.",0,0,1,0,0,1
Oil Field Equipment Company,0,0,1,0,0,1
"Oil Group, Inc.",0,0,1,0,0,1
Oil Income Corp.,0,0,1,0,0,1
Oil Investment Co.,0,0,1,0,0,1
"Oil Producers, Ltd.",0,0,1,0,0,1
Oil Ridge Oil & Refining Co.,0,0,1,0,0,1
"Oil Search Corp., Ltd",0,0,1,0,0,1
"Oil Securities, Inc.",0,0,1,0,0,1
Oil Well Abandonment Co.,0,0,1,0,0,1
Oilfield Equipment & Supply Co.,0,0,1,0,0,1
Oilfield Rental & Sales Co.,0,0,1,0,0,1
Oilfields Trucking Co.,0,0,1,0,0,1
Ojai Pacific Corp.,0,0,1,0,0,1
Old Colony Trust No. 1,0,0,1,0,0,1
Old Mission Oil Co.,0,0,1,0,0,1
Olive Petroleum Co.,0,0,1,0,0,1
"Olympic Corp., Ltd.",0,0,1,0,0,1
Olympic Realty Corp.,0,0,1,0,0,1
Oneto Bros,0,0,1,0,0,1
"Onyx Oil Co., Ltd.",0,0,1,0,0,1
Opm Oil Co.,0,0,1,0,0,1
Optic Oil Syndicate,0,0,1,0,0,1
Orange County Sanitation District,0,0,1,0,0,1
"Orangethorpe Corp., Ltd.",0,0,1,0,0,1
Oregon Oil and Dev. Co.,0,0,1,0,0,1
Orestimba Oil Co.,0,0,1,0,0,1
"Orestimba Oil Co., Ltd.",0,0,1,0,0,1
Orinda Petro. Co.,0,0,1,0,0,1
Orion Expl. Co.,0,0,1,0,0,1
"Orland Oil Synd., Ltd.",0,0,1,0,0,1
Orlando Oil Corp.,0,0,1,0,0,1
Oro Negra Dev. Corp.,0,0,1,0,0,1
Oro Negro/McKenzie,0,0,1,0,0,1
Oro W L & P Co.,0,0,1,0,0,1
ORS Development Corp.,0,0,1,0,0,1
Ortega Oil Co.,0,0,1,0,0,1
Orville Stanford Inc.,0,0,1,0,0,1
Oscar F. Catalano & Trueman W. Stansbury,0,0,1,0,0,1
Oscar S. Norton and William Jones,0,0,1,0,0,1
Osmore Cook,0,0,1,0,0,1
OTEC,0,0,1,0,0,1
Otis Hoyt Company,0,0,1,0,0,1
Otto W. Clark,0,0,1,0,0,1
Otto Waldinger,0,0,1,0,0,1
Overland Petroleum Co.,0,0,1,0,0,1
Owens & Applegate,0,0,1,0,0,1
Owens & Dunsmoor,0,0,1,0,0,1
Owner's Oil Producing Co.,0,0,1,0,0,1
"Oxnard Oil Co., Ltd",0,0,1,0,0,1
Oxnard Operations,0,0,1,0,0,1
"OXY Lost Hills, Inc.",0,0,1,0,0,1
Ozark Oil Co.,0,0,1,0,0,1
Ozena Oil Co.,0,0,1,0,0,1
P & H Oil Co.,0,0,1,0,0,1
P & H Wrecking Co.,0,0,1,0,0,1
P & M Oil Co.,0,0,1,0,0,1
P & W Oil Co.,0,0,1,0,0,1
P and R Assoc.,0,0,1,0,0,1
P G & E Res. Co.,0,0,1,0,0,1
P. B. Anderson,0,0,1,0,0,1
P. D. Smith,0,0,1,0,0,1
P. F. Harbrecht,0,0,1,0,0,1
P. G. Cumming,0,0,1,0,0,1
P. H. Phillips,0,0,1,0,0,1
P. J. & J. E. O'Melia,0,0,1,0,0,1
P. K. & P. Oil Co.,0,0,1,0,0,1
P. L. J. Co.,0,0,1,0,0,1
P. L. Jewett et al,0,0,1,0,0,1
P. M. Oil & Gas Co.,0,0,1,0,0,1
P. Ray Asmussen,0,0,1,0,0,1
P. Welch,0,0,1,0,0,1
Pacific-Venice Oil Corp.,0,0,1,0,0,1
Pacific Alliance Medical Center,0,0,1,0,0,1
Pacific Butte Mines Co.,0,0,1,0,0,1
Pacific Clay Products,0,0,1,0,0,1
Pacific Coast Land & Oil,0,0,1,0,0,1
Pacific Consolidated Oil Co.,0,0,1,0,0,1
Pacific Crude Oil,0,0,1,0,0,1
Pacific Dev. Co.,0,0,1,0,0,1
Pacific Empire Petro. Inc.,0,0,1,0,0,1
Pacific Exploration Corp.,0,0,1,0,0,1
Pacific Gulf Oil Company,0,0,1,0,0,1
Pacific Inland Oil Co,0,0,1,0,0,1
Pacific National Co.,0,0,1,0,0,1
Pacific Petro. Prod. Inc.,0,0,1,0,0,1
Pacific Petro. Syndicate,0,0,1,0,0,1
Pacific Slope Oil Co.,0,0,1,0,0,1
Pacific Western Oil Co.,0,0,1,0,0,1
Pacific Western Oil Corporation,0,0,1,0,0,1
Pacific Wst. Oil & Getty Inc.,0,0,1,0,0,1
Pacifica Medical Center,0,0,1,0,0,1
Pacifica Oil Company,0,0,1,0,0,1
Pacoima Petro. & Helium Gas,0,0,1,0,0,1
Padran Oil Corp.,0,0,1,0,0,1
Padres Oil Co.,0,0,1,0,0,1
Padua Oil Co.,0,0,1,0,0,1
Page and Davis,0,0,1,0,0,1
Page Petro. Corp.,0,0,1,0,0,1
Pago Grande Oil Co.,0,0,1,0,0,1
Pal Pen Oil Co.,0,0,1,0,0,1
Palm Ridge Oil Co.,0,0,1,0,0,1
Palma Oil Co.,0,0,1,0,0,1
Palmer Stendel Oil Corp.,0,0,1,0,0,1
Paloma Oil Co.,0,0,1,0,0,1
Palomar Petro. Co.,0,0,1,0,0,1
Palos Verdes Corp.,0,0,1,0,0,1
Palos Verdes Estates Inc.,0,0,1,0,0,1
Pan Cal Petro. Co.,0,0,1,0,0,1
Panorama Oil Company,0,0,1,0,0,1
"Panther Energy Company, LLC",0,0,1,0,0,1
Par-Bell Oil Co.,0,0,1,0,0,1
Par Petroleum Co.,0,0,1,0,0,1
Para-Cal Oil Corp.,0,0,1,0,0,1
Paramount Oil Co.,0,0,1,0,0,1
Park B. Jolley,0,0,1,0,0,1
Parker T. DeVilbiss,0,0,1,0,0,1
Parsons Petro. Co.,0,0,1,0,0,1
Participants Petro Corp,0,0,1,0,0,1
Parton Transportation Co. & Assoc,0,0,1,0,0,1
Paso Robles Associated Oil Co.,0,0,1,0,0,1
Paso Robles Gas Co.,0,0,1,0,0,1
Paso Robles Oil Trust,0,0,1,0,0,1
Patdot Oil Co.,0,0,1,0,0,1
Patos Drilling Co.,0,0,1,0,0,1
Patton-Baldwin Oil Co.,0,0,1,0,0,1
"Patton & Goldman, Trustees",0,0,1,0,0,1
Paul A. Medearis,0,0,1,0,0,1
Paul Bauer,0,0,1,0,0,1
Paul C Teas Oper.,0,0,1,0,0,1
Paul E. Berry,0,0,1,0,0,1
Paul E. Gregg & Assoc.,0,0,1,0,0,1
Paul E. Lehr and Anah Lehr,0,0,1,0,0,1
Paul E. Olson & Sons & R. Wayne Olson,0,0,1,0,0,1
Paul F. Travis,0,0,1,0,0,1
"Paul Fiorovich, Jr. et al",0,0,1,0,0,1
Paul Greening,0,0,1,0,0,1
Paul J. Donavan & E. L. Brace,0,0,1,0,0,1
Paul J. Patton,0,0,1,0,0,1
"Paul Jr., & Ruth Fiorovich & W.P. Lasher",0,0,1,0,0,1
Paul L. Cooper et al,0,0,1,0,0,1
Paul L. Snyder,0,0,1,0,0,1
Paul M. Lewis,0,0,1,0,0,1
Paul N. Baker,0,0,1,0,0,1
Paul O. Waggoner,0,0,1,0,0,1
Paul W. Trousdale and T. K. Sterling,0,0,1,0,0,1
Paula Oil Co.,0,0,1,0,0,1
Pauline F. Hughes,0,0,1,0,0,1
Pauly Petroleum Inc.,0,0,1,0,0,1
"Payette, Callaghan & .",0,0,1,0,0,1
"PCB Oil Co., Ltd.",0,0,1,0,0,1
Pearl Durnal,0,0,1,0,0,1
Pearson & Phillips,0,0,1,0,0,1
Pearson Petro. Corp.,0,0,1,0,0,1
Pebble Beach Oil Co.,0,0,1,0,0,1
Pedersen & Abacherli,0,0,1,0,0,1
Pedersen Development Co.,0,0,1,0,0,1
Peerless Associates,0,0,1,0,0,1
"Peerless Laundry Co., Ltd",0,0,1,0,0,1
Penge Oil Co.,0,0,1,0,0,1
Penn-Kan Oil Co.,0,0,1,0,0,1
"Penn, Inc.",0,0,1,0,0,1
"Pennant Operating Co., Oper.",0,0,1,0,0,1
Pennzoil Company,0,0,1,0,0,1
Pentagon Oil Co.,0,0,1,0,0,1
Peoples Associated Oil Co.,0,0,1,0,0,1
Per-Col Oil Co.,0,0,1,0,0,1
Perri Oil Co.,0,0,1,0,0,1
Perry Drlg. Co.,0,0,1,0,0,1
Pestana Oil Co.,0,0,1,0,0,1
"Petaluma Expl. Co., Ltd.",0,0,1,0,0,1
"Petcamp Oil Co., Ltd.",0,0,1,0,0,1
Petco Oil,0,0,1,0,0,1
Peter A. Hilliard,0,0,1,0,0,1
Peter J. Belluci,0,0,1,0,0,1
Peter Schmit,0,0,1,0,0,1
Peter Schwabenland,0,0,1,0,0,1
Pethybridge and Erlich,0,0,1,0,0,1
"Petrex, Inc.",0,0,1,0,0,1
Petrie Associates,0,0,1,0,0,1
"Petro-Gas, Inc.",0,0,1,0,0,1
Petro-Tek,0,0,1,0,0,1
"Petro-Well Production Co., Ltd.",0,0,1,0,0,1
"Petro Tieg, Inc.",0,0,1,0,0,1
Petrodyne Co.,0,0,1,0,0,1
Petrol Producers and Refiners,0,0,1,0,0,1
"Petroleum Consolidated, Ltd.",0,0,1,0,0,1
Petroleum Enterprises Co.,0,0,1,0,0,1
"Petroleum Exploration Co., Inc.",0,0,1,0,0,1
Petroleum Investment Company,0,0,1,0,0,1
Petroleum Prod. Engineers,0,0,1,0,0,1
Petroleum Producers Inc.,0,0,1,0,0,1
Petroleum Products Syndicate,0,0,1,0,0,1
Petroleum Properties Inc.,0,0,1,0,0,1
Petroleum Reserve Corporation,0,0,1,0,0,1
Petroleum Supply Company,0,0,1,0,0,1
Petrolia Corp.,0,0,1,0,0,1
"Petrolphysics, Ltd.",0,0,1,0,0,1
Petroly Oil Co.,0,0,1,0,0,1
Petromont Oil Corp.,0,0,1,0,0,1
"Petropar, Inc.",0,0,1,0,0,1
Petsec Energy Inc.,0,0,1,0,0,1
Phil H. Phillips,0,0,1,0,0,1
"Philco Petro. Co., Ltd.",0,0,1,0,0,1
Philip R. Brain Oil Co.,0,0,1,0,0,1
Philip W. Witte,0,0,1,0,0,1
Phillip T. Sharples,0,0,1,0,0,1
Phillips Investment Corp. of Calif. and John S. Hagestad Drilling Co.,0,0,1,0,0,1
Phoenix-Hinds Oil,0,0,1,0,0,1
Pico Dome Oil & Gas Co.,0,0,1,0,0,1
Pierce Petroleum Corp. Inc.,0,0,1,0,0,1
Pike and Associates,0,0,1,0,0,1
Pine Canyon Oil Co.,0,0,1,0,0,1
Pine Ridge Oil Co.,0,0,1,0,0,1
Pioneer,0,0,1,0,0,1
Pioneer Holding Co.,0,0,1,0,0,1
"Pioneer Petro. Co., Ltd",0,0,1,0,0,1
Pira & DeSpain,0,0,1,0,0,1
Piru Creek Ventura,0,0,1,0,0,1
Piru Petro. Co.,0,0,1,0,0,1
Pismo Oil Co.,0,0,1,0,0,1
Piute Holding Co.,0,0,1,0,0,1
Pixley Development,0,0,1,0,0,1
Placerita Oil Prod.,0,0,1,0,0,1
Plains Oil Co.,0,0,1,0,0,1
Plains Oil Co. No. 4,0,0,1,0,0,1
Pleyto Cons. Oil,0,0,1,0,0,1
Plyler Oil Operations,0,0,1,0,0,1
Plymouth Oil Co.,0,0,1,0,0,1
Pohle Oil & Gas Inc.,0,0,1,0,0,1
Polvadero Oil Co.,0,0,1,0,0,1
Pombco Oil Co.,0,0,1,0,0,1
Pomoc Oil Co.,0,0,1,0,0,1
Pomona Oil Co.,0,0,1,0,0,1
"Pool California Energy Services, Inc.",0,0,1,0,0,1
Porsco Operating Co.,0,0,1,0,0,1
Portable Dril. Equip.& Supp.Co.,0,0,1,0,0,1
"Porter Sesnon, Barbara Sesnon Cartan, Wm. T. Sesnon, Jr., Tenants in Common",0,0,1,0,0,1
Porterville Oil Syndicate,0,0,1,0,0,1
Positive Oil Co.,0,0,1,0,0,1
Poso Oil Co.,0,0,1,0,0,1
Poso Pete Co.,0,0,1,0,0,1
Poso Petroleum Co.,0,0,1,0,0,1
Potrero Oil Co.,0,0,1,0,0,1
Power Oil Co.,0,0,1,0,0,1
Pozo Grande Oil Co.,0,0,1,0,0,1
Prado Basin Oil Co.,0,0,1,0,0,1
Premier Extension Oil Co.,0,0,1,0,0,1
Premier Petroleum Corp.,0,0,1,0,0,1
"Presley, Wattenbarger & Cook",0,0,1,0,0,1
Prestidge Oil Company,0,0,1,0,0,1
Priest Valley Petro Co.,0,0,1,0,0,1
Primar Oil Corp. Ltd.,0,0,1,0,0,1
Prime Monterey Energy LLC,0,0,1,0,0,1
"Producing Properties, Inc.",0,0,1,0,0,1
Progressive Syndicate,0,0,1,0,0,1
"Prologis, L.P.",0,0,1,0,0,1
Prospective Inv.& Trad. Co. Ltd,0,0,1,0,0,1
"Prosperity Oil Co., Ltd.",0,0,1,0,0,1
Providence Oil Co.,0,0,1,0,0,1
Prudential Oil Co.,0,0,1,0,0,1
Prudential Pet. Co.,0,0,1,0,0,1
"Public Petroleum Company, Inc.",0,0,1,0,0,1
"Pueblo Oil co., Ltd.",0,0,1,0,0,1
Puente Dev. Assoc.,0,0,1,0,0,1
Puente Petro. Corp.,0,0,1,0,0,1
Purissima Hills Oil Co.,0,0,1,0,0,1
Puritan Oil & Refining Co.,0,0,1,0,0,1
Putah Creek Venture,0,0,1,0,0,1
Pyramid Hills Syndicate,0,0,1,0,0,1
Pyramid Prod. Co.,0,0,1,0,0,1
Pyramid Resources Inc.,0,0,1,0,0,1
Q. & S. Oil Co.,0,0,1,0,0,1
Quadrant Operating Co.,0,0,1,0,0,1
Quadri Petro. Co.,0,0,1,0,0,1
Queen and Scott,0,0,1,0,0,1
"Quinby Oil, Inc.",0,0,1,0,0,1
Quinn Ranch Oil Corp.,0,0,1,0,0,1
Quinn Ranch Oil Development Corporation,0,0,1,0,0,1
R-K Drilling Co. Inc.,0,0,1,0,0,1
R-K Oil Co.,0,0,1,0,0,1
R & K Hammerlee,0,0,1,0,0,1
R & L Prod. Co.,0,0,1,0,0,1
"R & R Entertainment, Inc.",0,0,1,0,0,1
R & R Oil Co.,0,0,1,0,0,1
"R. A. Betz, Oper.",0,0,1,0,0,1
R. A. Dean & Assoc.,0,0,1,0,0,1
"R. A. Rowan, E. Armstrong & J. Babcock",0,0,1,0,0,1
R. B. Blodget Company,0,0,1,0,0,1
R. B. Jackson & C. H. Chamberlain,0,0,1,0,0,1
R. B. Jackson & Cliff E. Zillgitt,0,0,1,0,0,1
R. B. Jackson and B. W. McCune,0,0,1,0,0,1
R. B. O'Meara,0,0,1,0,0,1
"R. Bruce Grey, Operator",0,0,1,0,0,1
R. C. Foerster & C C Kreis,0,0,1,0,0,1
R. C. Williams,0,0,1,0,0,1
R. Carl Larkins,0,0,1,0,0,1
R. D. Clarke,0,0,1,0,0,1
R. D. Coffee,0,0,1,0,0,1
R. D. Mathis,0,0,1,0,0,1
R. D. Willard,0,0,1,0,0,1
R. E. Bering - Kern Operator,0,0,1,0,0,1
R. E. Bering & Assoc.,0,0,1,0,0,1
R. E. Bering & The Mitchel Co.,0,0,1,0,0,1
"R. E. Bering, Trustee",0,0,1,0,0,1
R. E. Burke Trustee,0,0,1,0,0,1
R. E. Doherty,0,0,1,0,0,1
R. E. Havenstrite,0,0,1,0,0,1
R. E. Hibbert,0,0,1,0,0,1
R. E. Peterson,0,0,1,0,0,1
R. E. Struve,0,0,1,0,0,1
R. E. Troutt,0,0,1,0,0,1
R. E. Y. Energy Associates,0,0,1,0,0,1
R. F. D. Petro. Co.,0,0,1,0,0,1
R. G. Greene,0,0,1,0,0,1
R. H.  Beel Dev. Co.,0,0,1,0,0,1
R. H. Bess,0,0,1,0,0,1
R. H. Lockbaum,0,0,1,0,0,1
R. H. McIntosh,0,0,1,0,0,1
R. H. Sayers,0,0,1,0,0,1
R. H. Vaughan & Associates,0,0,1,0,0,1
R. Hector McIntosh,0,0,1,0,0,1
R. L. Bauman et al,0,0,1,0,0,1
R. L. Triplett,0,0,1,0,0,1
"R. L. Wheelock, Collins, Abercrombie &.",0,0,1,0,0,1
R. M. Claire,0,0,1,0,0,1
"R. M. Kiesau, Operator",0,0,1,0,0,1
R. Mausard & A.L. Jameson,0,0,1,0,0,1
R. R. Richey,0,0,1,0,0,1
R. Robert Renaud,0,0,1,0,0,1
R. S. Ballantyne,0,0,1,0,0,1
R. S. Lytle,0,0,1,0,0,1
R. S. Miesse,0,0,1,0,0,1
R. Scott Price,0,0,1,0,0,1
R. T. Colter and W. G. McAdoo,0,0,1,0,0,1
"R. V. Quinn, Oper.",0,0,1,0,0,1
R. W. and Geo. H. Jackson,0,0,1,0,0,1
R. W. B. Gas & Oil Co.,0,0,1,0,0,1
R. W. Caspers,0,0,1,0,0,1
R. W. Cypher & Assoc.,0,0,1,0,0,1
R. W. Jerman & Frank R. Bartee,0,0,1,0,0,1
R. W. Jerman and Associates,0,0,1,0,0,1
R. W. McBurney,0,0,1,0,0,1
R. W. Russell,0,0,1,0,0,1
"R. W. Willis, Operator",0,0,1,0,0,1
R. Y. H. Oil Co.,0,0,1,0,0,1
R. Y. Hanlon,0,0,1,0,0,1
R.F.D. Co.,0,0,1,0,0,1
"Ra-Lite Petro., Inc.",0,0,1,0,0,1
Raco Oil Co.,0,0,1,0,0,1
Rae Oil Co.,0,0,1,0,0,1
Rako Oil Co.,0,0,1,0,0,1
Raldo Exploration Co.,0,0,1,0,0,1
Ralph J. Brown,0,0,1,0,0,1
Ralph Lavin Trustee,0,0,1,0,0,1
Ramona Home,0,0,1,0,0,1
Ranchers' Oil Co.,0,0,1,0,0,1
Rancho de la Puente Oil Co.,0,0,1,0,0,1
Rancho Energy Consultants Inc,0,0,1,0,0,1
"Rancho Oil Corp., Ltd.",0,0,1,0,0,1
"Rancho Oils, Inc.",0,0,1,0,0,1
Rancho Sausal Petro. Co.,0,0,1,0,0,1
Randall E. Presley,0,0,1,0,0,1
Randall Oil Corp.,0,0,1,0,0,1
Randy J. & Deborah R. Allison,0,0,1,0,0,1
"Range Oil Co., Ltd.",0,0,1,0,0,1
Range Oil Corp.& Lee A. Ault,0,0,1,0,0,1
Rankin & Taylor,0,0,1,0,0,1
Rankin & Williams,0,0,1,0,0,1
Rapp Oil Co.,0,0,1,0,0,1
Rawe-Berger and Assoc.,0,0,1,0,0,1
Ray E. McLane & Associates,0,0,1,0,0,1
Ray J. Flanders,0,0,1,0,0,1
Ray M. Uyeshima and H. T. Hoover,0,0,1,0,0,1
"Ray Mustang, Oper.",0,0,1,0,0,1
Ray W. Stevens,0,0,1,0,0,1
Ray W. Stevens & Associates,0,0,1,0,0,1
Ray W. Wilson,0,0,1,0,0,1
"Rayatt Oil Corp., Ltd.",0,0,1,0,0,1
Rayger Oil Company,0,0,1,0,0,1
Raymond D. Herzog,0,0,1,0,0,1
Raymond D. Weller,0,0,1,0,0,1
Raymond Oil Co.,0,0,1,0,0,1
Razorback Oil & Gas Co.,0,0,1,0,0,1
Recknagel & Owens,0,0,1,0,0,1
Red Bluff Assoc.,0,0,1,0,0,1
Red Star Oil Co. and Ward,0,0,1,0,0,1
"Red Willow California, LLC",0,0,1,0,0,1
Redi Corp.,0,0,1,0,0,1
Reed Elkins,0,0,1,0,0,1
Reef Oil Co.,0,0,1,0,0,1
Reese Hylton,0,0,1,0,0,1
"Reeves Aylmore, Jr.",0,0,1,0,0,1
Refugio Oil Co.,0,0,1,0,0,1
"Regina Oil Corp., Ltd.",0,0,1,0,0,1
Register Oil Co.,0,0,1,0,0,1
Reliance Producers Inc.,0,0,1,0,0,1
Repetto Hills Petro. Corp.,0,0,1,0,0,1
Republic Producing Co.,0,0,1,0,0,1
Reservoir Hill Gasoline,0,0,1,0,0,1
Retari Co. Inc.,0,0,1,0,0,1
"Reuben Agran, Trustee",0,0,1,0,0,1
Reunion Energy Company,0,0,1,0,0,1
Rex C Gale,0,0,1,0,0,1
Rex Spaith,0,0,1,0,0,1
Rex W. Jones,0,0,1,0,0,1
Rexroth & Rexroth,0,0,1,0,0,1
Reynolds-Knudsen,0,0,1,0,0,1
Reynolds Exploration Co.,0,0,1,0,0,1
Reynolds Oil Co.,0,0,1,0,0,1
Richard C. Davoust,0,0,1,0,0,1
Richard D. Carpenter,0,0,1,0,0,1
Richard E. Frasch,0,0,1,0,0,1
Richard E. Tifft,0,0,1,0,0,1
Richard E. Viertel,0,0,1,0,0,1
Richard H Delano,0,0,1,0,0,1
Richard L. Parris & L. L. Curyea,0,0,1,0,0,1
Richard Miller,0,0,1,0,0,1
Richard O. Maze,0,0,1,0,0,1
Richard Oil Co.,0,0,1,0,0,1
Richard P. Kelter,0,0,1,0,0,1
Richard R. Workman and Carl O. Spath,0,0,1,0,0,1
Richard S. Prather,0,0,1,0,0,1
Richards & Devine,0,0,1,0,0,1
Richards Oil Co.,0,0,1,0,0,1
Ridgewood Energy Industries Inc.,0,0,1,0,0,1
Ried Development Co.,0,0,1,0,0,1
Rincon Operating Co.,0,0,1,0,0,1
Ring Oil Co. Ltd,0,0,1,0,0,1
Rinide Oil Co.,0,0,1,0,0,1
Rio Bravo Disposal Facility,0,0,1,0,0,1
Rio Bravo Poso,0,0,1,0,0,1
Rio Cal Petroleum Corp. Ltd.,0,0,1,0,0,1
Riokern Oil Co.,0,0,1,0,0,1
Rippy-Robinett-Post,0,0,1,0,0,1
Riva Oil & Gas Co.,0,0,1,0,0,1
Riverbend Oil Corp.,0,0,1,0,0,1
Riverside-Ventura Oil Co.,0,0,1,0,0,1
Riviera Petroleum Co.,0,0,1,0,0,1
RNS Oil Co.,0,0,1,0,0,1
Robal Petro. Ltd.,0,0,1,0,0,1
Robert & Ada Winton,0,0,1,0,0,1
Robert B. Doe,0,0,1,0,0,1
"Robert B. Doe, Operator",0,0,1,0,0,1
Robert B. Law Jr.,0,0,1,0,0,1
"Robert B. Moran, Operator",0,0,1,0,0,1
"Robert Bromberg, Trustee for Community.",0,0,1,0,0,1
Robert C Wilcox,0,0,1,0,0,1
"Robert C. Gillis, Receiver (for Western Oil & Refining Co.)",0,0,1,0,0,1
Robert Dopyera and M. V. Bartch,0,0,1,0,0,1
"Robert E. & Ruby C. Beasley, Trustees",0,0,1,0,0,1
Robert E. Abbe,0,0,1,0,0,1
"Robert E. Baumgarten, Oper.",0,0,1,0,0,1
Robert E. Jackson,0,0,1,0,0,1
Robert Egger,0,0,1,0,0,1
"Robert H. Miller, Operator",0,0,1,0,0,1
Robert Jay Brandt,0,0,1,0,0,1
Robert L. Ibsen,0,0,1,0,0,1
Robert S. Lytle,0,0,1,0,0,1
Robert S. Rocco,0,0,1,0,0,1
Robert Seanor,0,0,1,0,0,1
Robert Tanguay,0,0,1,0,0,1
Robert W. Moore,0,0,1,0,0,1
Robert W. Ogle,0,0,1,0,0,1
Robert W. Shull Co. Property Mgmnt.,0,0,1,0,0,1
Robert Watchorn,0,0,1,0,0,1
Robert Whisenant,0,0,1,0,0,1
Roberts & Avery,0,0,1,0,0,1
Roberts Island-Ltd.,0,0,1,0,0,1
Robin Petro. Co.,0,0,1,0,0,1
Robinette & Daniels,0,0,1,0,0,1
Robst,0,0,1,0,0,1
Rocima Oil Co.,0,0,1,0,0,1
Rock Amalgamated,0,0,1,0,0,1
Rock Creek Dev. Co.,0,0,1,0,0,1
Rocket Oil & Gas Corp.,0,0,1,0,0,1
Rockwell & Hansmeyer,0,0,1,0,0,1
Rohrig Petroleum Co.,0,0,1,0,0,1
Rolling Hills Assoc,0,0,1,0,0,1
Rolling Hills Country Club,0,0,1,0,0,1
Romara Energy Inc.,0,0,1,0,0,1
Romaro Oil Company,0,0,1,0,0,1
Ronald A Louden,0,0,1,0,0,1
Ronald C. Smith and Assoc.,0,0,1,0,0,1
Rood-Miller Assoc.,0,0,1,0,0,1
Rood Assoc.,0,0,1,0,0,1
"Root, Shoup and Millikin",0,0,1,0,0,1
Roscoe Oil Co.,0,0,1,0,0,1
Rose Matthes Osborn,0,0,1,0,0,1
Rose Oil Co.,0,0,1,0,0,1
Rosebrand Petro. Co.,0,0,1,0,0,1
Rotary Drillers Inc.,0,0,1,0,0,1
Rothschild Oil Co. & Josephine E. Kebow,0,0,1,0,0,1
Rougeot Oil & Gas Corp.,0,0,1,0,0,1
"Round Mountain Oil Company, Ltd.",0,0,1,0,0,1
Rowan Oil Co.,0,0,1,0,0,1
Rowepet Oil Co.,0,0,1,0,0,1
Roy C. and Georgette M. Cravey,0,0,1,0,0,1
"Roy E. Fife, Jr.",0,0,1,0,0,1
"Roy Edward Fife, Clifton Cramer and Johnie O. Owen",0,0,1,0,0,1
"Roy Hitchcock, Oper.",0,0,1,0,0,1
Roy Lee,0,0,1,0,0,1
Roy M. Christenson,0,0,1,0,0,1
Roy M. Rhoads,0,0,1,0,0,1
Roy N. Bishop Trustee,0,0,1,0,0,1
Roy P. Dolley,0,0,1,0,0,1
Roy R. Farmer,0,0,1,0,0,1
"Roy W. Young, Inc.",0,0,1,0,0,1
Royal Oil Co.,0,0,1,0,0,1
"Royal Pacific Securities, Inc.",0,0,1,0,0,1
Royal Petro Co. of Cal Inc.,0,0,1,0,0,1
Rubicon Oil Co.,0,0,1,0,0,1
Rubin Oil Co.,0,0,1,0,0,1
Ruby Oil Company,0,0,1,0,0,1
"Ruchti Petro. Co., Inc.",0,0,1,0,0,1
"Rucker, Smith, Croul",0,0,1,0,0,1
Rudi and Associates,0,0,1,0,0,1
Rudolph Pageman and Edward Hennes,0,0,1,0,0,1
Rueter Oil Co.,0,0,1,0,0,1
Runnels Exploration Co.,0,0,1,0,0,1
Russel R. Temple,0,0,1,0,0,1
Russell A. Brown,0,0,1,0,0,1
Russell B. Coffman,0,0,1,0,0,1
"Russell, Chambers & Russell",0,0,1,0,0,1
"Russell, Willis & Vaughan, Ltd.",0,0,1,0,0,1
Ruth J. Bishop,0,0,1,0,0,1
Ryan and Morrow,0,0,1,0,0,1
S-K-L Associates,0,0,1,0,0,1
S-M Oil Co.,0,0,1,0,0,1
S. & K. Oil Company,0,0,1,0,0,1
S. & R. Well No. 1,0,0,1,0,0,1
S. & V. Oil Co.,0,0,1,0,0,1
S. A. Dalzell,0,0,1,0,0,1
S. Block & Max Rouse,0,0,1,0,0,1
S. E. Hogue,0,0,1,0,0,1
S. E. Tweedy,0,0,1,0,0,1
S. F. Easterbrooks,0,0,1,0,0,1
S. F. Harris,0,0,1,0,0,1
S. F. Waggenseller & J.J. August,0,0,1,0,0,1
"S. H. Baker, C. H. Leyse, and Geo. M. Sonne, Trustees",0,0,1,0,0,1
S. H. Havlin & F.M. Pottenger,0,0,1,0,0,1
S. I. Williams,0,0,1,0,0,1
S. L. Hartman,0,0,1,0,0,1
S. M. Brooks & Assoc.,0,0,1,0,0,1
S. M. Brooks Drilling Co.,0,0,1,0,0,1
S. P. Lipoma Co.,0,0,1,0,0,1
S. R. Bowen Co.,0,0,1,0,0,1
S. R. Ross,0,0,1,0,0,1
S. S. & Mary E. Russell,0,0,1,0,0,1
S. S. Wold,0,0,1,0,0,1
S. S. Wortley,0,0,1,0,0,1
S. T. Alexander,0,0,1,0,0,1
S. W. Bradford,0,0,1,0,0,1
S.A.M. Enterprises,0,0,1,0,0,1
"S.M.S. Briners, Inc.",0,0,1,0,0,1
"SA Athnassia, LLC",0,0,1,0,0,1
Sacramento Petro. Co.,0,0,1,0,0,1
Salient Oil Co.,0,0,1,0,0,1
Salmon Creek Oil Co.,0,0,1,0,0,1
Salt Lake 99 LLC,0,0,1,0,0,1
"Salvatore Natoli, Jr.",0,0,1,0,0,1
Sam B. Newman,0,0,1,0,0,1
Sam Clark,0,0,1,0,0,1
Sam F. Rhoads,0,0,1,0,0,1
Sam Freeman,0,0,1,0,0,1
Sam Joseph,0,0,1,0,0,1
Sam Levy,0,0,1,0,0,1
Sam Malis,0,0,1,0,0,1
Sam Manchel,0,0,1,0,0,1
Sam P. Mullen,0,0,1,0,0,1
"Samuel Bennett, Oper.",0,0,1,0,0,1
Samuel V. Cornell et al,0,0,1,0,0,1
San-Val Oil Co. Ltd.,0,0,1,0,0,1
"San Andres Oil Co., Inc.",0,0,1,0,0,1
San Caetano Oil Co.,0,0,1,0,0,1
"San Diego Dome Drilling Fund, Inc.",0,0,1,0,0,1
San Gabriel Oil Co.,0,0,1,0,0,1
San Joaquin Associates,0,0,1,0,0,1
San Joaquin Cogen Limited,0,0,1,0,0,1
San Joaquin Oil Co.,0,0,1,0,0,1
San Joaquin Petro. Co.,0,0,1,0,0,1
San Joaquin Valley Farm Lands Co.,0,0,1,0,0,1
San Joaquin Valley Oil & Dev. Assoc.,0,0,1,0,0,1
San Jose-Elk Hills Oil Co.,0,0,1,0,0,1
San Juan Oil Co.,0,0,1,0,0,1
San Juan Project,0,0,1,0,0,1
San Lucas Oil Co.,0,0,1,0,0,1
San Lucas Oil Co. Ltd.,0,0,1,0,0,1
San Marcus Oil Co.,0,0,1,0,0,1
San Marino Petro. Syndicate,0,0,1,0,0,1
San Mateo County Community College Dist.,0,0,1,0,0,1
San Miguel Cholame Syndicate,0,0,1,0,0,1
San Patricio Oil Co. Ltd.,0,0,1,0,0,1
San Pedro-Point Fermin Oil & Gas Co.,0,0,1,0,0,1
Sand Bowl Group,0,0,1,0,0,1
Sand Dune Oil Co.,0,0,1,0,0,1
Sandburg Petro. Co.,0,0,1,0,0,1
Sandee Oil Co.,0,0,1,0,0,1
Sandy Oil Company,0,0,1,0,0,1
"Sankey Oil Co., Inc.",0,0,1,0,0,1
Sanoma Gasoline Co.,0,0,1,0,0,1
Santa Barbara-Calif Oil C,0,0,1,0,0,1
Santa Barbara Asphalt & Refining Co.,0,0,1,0,0,1
Santa Barbara Oil and Gas Co.,0,0,1,0,0,1
Santa Barbara Oil Co.,0,0,1,0,0,1
Santa Clara Oil Co.,0,0,1,0,0,1
Santa Clara Petro.,0,0,1,0,0,1
Santa Cruz Expl,0,0,1,0,0,1
"Santa Fe Energy Operating Partners, L.P.",0,0,1,0,0,1
Santa Fe Extension,0,0,1,0,0,1
Santa Fe Springs Drilling Co.,0,0,1,0,0,1
Santa Fe Springs Oil Synd. No. 3,0,0,1,0,0,1
Santa Goleta Petro. Co.,0,0,1,0,0,1
Santa Lucia Oil,0,0,1,0,0,1
Santa Lucia Oil Co.,0,0,1,0,0,1
Santa Margarita Land & Cattle,0,0,1,0,0,1
Santa Maria Enterprise Oil Co.,0,0,1,0,0,1
"Santa Maria Land Co., Inc.",0,0,1,0,0,1
Santa Maria Midway Corp.,0,0,1,0,0,1
Santa Maria Pacific LLC,0,0,1,0,0,1
Santa Maria Petro. Corp.,0,0,1,0,0,1
Santa Paula Gravity Oil Co.,0,0,1,0,0,1
Santa Rosa Expl. Co.,0,0,1,0,0,1
Santa Susana Leasehold,0,0,1,0,0,1
Saphire Oil Co. (Sapphire?,0,0,1,0,0,1
Sara Orr,0,0,1,0,0,1
Saugus Dev. Co.,0,0,1,0,0,1
Savoy Petroleum Corp.,0,0,1,0,0,1
Say Energy Inc.,0,0,1,0,0,1
Scarab Oil Co.,0,0,1,0,0,1
Schirm & Rubenstein,0,0,1,0,0,1
Schmidt Assoc.,0,0,1,0,0,1
Schroeder Oil Syndicate,0,0,1,0,0,1
Schusterman Operating Co.,0,0,1,0,0,1
Schweitzer Expl. Co.,0,0,1,0,0,1
Scientific Oil Co.,0,0,1,0,0,1
Scoggin & Long,0,0,1,0,0,1
"Scotch Oil Co., Ltd.",0,0,1,0,0,1
Scott & Holbrook,0,0,1,0,0,1
Scott Brothers Well Drilling Co.,0,0,1,0,0,1
Scott Petro. Properties Inc.,0,0,1,0,0,1
Seacoast Oil Co.,0,0,1,0,0,1
Seal Beach Oil Co.,0,0,1,0,0,1
Searchlight Oil Co.,0,0,1,0,0,1
Seaward Petroleums Ltd.,0,0,1,0,0,1
"Sec. 27, Ltd.",0,0,1,0,0,1
"Second Chance Oil, LLC",0,0,1,0,0,1
Section 15 Oil Co.,0,0,1,0,0,1
Section Six Oil Co.,0,0,1,0,0,1
Section Thirty-One Pet Corp.Lt,0,0,1,0,0,1
Section Twenty Oil Co.,0,0,1,0,0,1
Section Two Oil Co.,0,0,1,0,0,1
Security Land & Royalty Co.,0,0,1,0,0,1
"Seigenberg, Horton & Rogers",0,0,1,0,0,1
Select Oil Co.,0,0,1,0,0,1
Semaphore Petroleum Corp.,0,0,1,0,0,1
Sequoia Oil & Gas Co.,0,0,1,0,0,1
Sergo Oil Co.,0,0,1,0,0,1
Sespe Crude Oil Co.,0,0,1,0,0,1
Sextette-Julien,0,0,1,0,0,1
Shafer & Wahlberg,0,0,1,0,0,1
Shaffer-Wintz Oil Co.,0,0,1,0,0,1
Shafter Oil Syndicate,0,0,1,0,0,1
Shale & Hills Co.,0,0,1,0,0,1
Shamrock Drilling Co. & Simmons,0,0,1,0,0,1
Shasta Pan Oil Co.,0,0,1,0,0,1
Shaw Oil Co.,0,0,1,0,0,1
Shaw Ranch Oil Co.,0,0,1,0,0,1
Sheldon & Gholson,0,0,1,0,0,1
Sheppard Oil Co.,0,0,1,0,0,1
Sherman F. Wagenseller,0,0,1,0,0,1
Sherman Oil Co.,0,0,1,0,0,1
Sherman S. Stephens,0,0,1,0,0,1
Shield Petro. Co.,0,0,1,0,0,1
Shirley Lease Co.,0,0,1,0,0,1
Shomy Oil Co.,0,0,1,0,0,1
Shore Oil Co.,0,0,1,0,0,1
Shoreline Oil Co.,0,0,1,0,0,1
Short Energy Co.,0,0,1,0,0,1
Shuman & Fitzgerald,0,0,1,0,0,1
Sierra Development Co.,0,0,1,0,0,1
Sierra Oil and Gas Co.,0,0,1,0,0,1
Sierra Slope Oil Co.,0,0,1,0,0,1
Signal Belle Oil Co.,0,0,1,0,0,1
Signal City Oil Corp.,0,0,1,0,0,1
Signal Finance Corp.,0,0,1,0,0,1
Signal Hill Dev. Co.,0,0,1,0,0,1
Signal Royalties Co.,0,0,1,0,0,1
"Signal Supply Co., Inc.",0,0,1,0,0,1
Signal Syndicate No. 4,0,0,1,0,0,1
Signal Union Syndicate,0,0,1,0,0,1
Signet Oil Co.,0,0,1,0,0,1
Signet Operating & Expl. Co.,0,0,1,0,0,1
Silver Bullion Co.,0,0,1,0,0,1
Silver Circle Oil Co.,0,0,1,0,0,1
Silver Leaf Oil Co.,0,0,1,0,0,1
"Simco, Inc.",0,0,1,0,0,1
Simi Oil & Refining Co.,0,0,1,0,0,1
Simmons Oil Inc.,0,0,1,0,0,1
Simplex Petro. Corp.,0,0,1,0,0,1
Sinclair Oil & Gas Co.,0,0,1,0,0,1
Sisson & Wisdom,0,0,1,0,0,1
"Site Resources One, LLC",0,0,1,0,0,1
Sixty-Six Oil Development Assoc.,0,0,1,0,0,1
"SJM Oil, LLC",0,0,1,0,0,1
"Skay Exploration, Ltd.",0,0,1,0,0,1
Skepco Oil Corp.,0,0,1,0,0,1
Skinner & Jasper,0,0,1,0,0,1
Skookum Oil & Invest Corp.,0,0,1,0,0,1
"Skylark Manufacturing Company, Inc.",0,0,1,0,0,1
Skyline Petro.,0,0,1,0,0,1
"Skyview Holdings, Inc.",0,0,1,0,0,1
Slayton Drilling Co.,0,0,1,0,0,1
Sleeper Ridge Oil Co.,0,0,1,0,0,1
"Slick Oil Co., Ltd.",0,0,1,0,0,1
"Slim Harrell Assoc., Ltd.",0,0,1,0,0,1
Sloan Oil Co.,0,0,1,0,0,1
Smith Ranch Oil Co.,0,0,1,0,0,1
"Smith, Rucker, Wilson",0,0,1,0,0,1
SMT Corporation,0,0,1,0,0,1
Smuggler-Divide Mining Co.,0,0,1,0,0,1
Snell Drilling Co.,0,0,1,0,0,1
Snyder & Hoff,0,0,1,0,0,1
"Snyder & Weaver, Partnership",0,0,1,0,0,1
So Hi Oil Company,0,0,1,0,0,1
So Pac Co. Fuel Oil Dept,0,0,1,0,0,1
So. Coyote Creek Expl. Prgm.Ltd,0,0,1,0,0,1
Sohio Petroleum Company,0,0,1,0,0,1
"Sol Posner, Operator for National Tungsten Corp.",0,0,1,0,0,1
Solar Basin Oil Co.,0,0,1,0,0,1
"Solar Oil Co., Inc.",0,0,1,0,0,1
Solemint Petro. Corp.,0,0,1,0,0,1
Song Doan Nevada Trust,0,0,1,0,0,1
"Sonoma Oil Co., Inc.",0,0,1,0,0,1
Soquel Canon Co.,0,0,1,0,0,1
South Coalinga Oil Co.,0,0,1,0,0,1
South Coast Oil,0,0,1,0,0,1
South Dome Oil Co.,0,0,1,0,0,1
South Edison Associates,0,0,1,0,0,1
South Fork Ranch,0,0,1,0,0,1
South Orcutt Oil Co.,0,0,1,0,0,1
South Santa Paula Petro. Co.,0,0,1,0,0,1
South Tapo Canyon Limited,0,0,1,0,0,1
Southbell Oil Company,0,0,1,0,0,1
Souther Leasehold,0,0,1,0,0,1
Southern Belle Oil Co.,0,0,1,0,0,1
Southern California Petroleum Corp.,0,0,1,0,0,1
Southern California Rapid Transit Dist.,0,0,1,0,0,1
Southern California Salvage Co.,0,0,1,0,0,1
Southern Counties Petro. & Drilling.,0,0,1,0,0,1
"Southern Empire Petro., Inc.",0,0,1,0,0,1
Southern Pacific Land Co.,0,0,1,0,0,1
Southern Union Production Company,0,0,1,0,0,1
Southland Gas Company,0,0,1,0,0,1
Southland Oil Co.,0,0,1,0,0,1
Southland Petro. Co.,0,0,1,0,0,1
Southwest Oil Fields Service Co.,0,0,1,0,0,1
"Southwest Oilwell Service, Inc.",0,0,1,0,0,1
Southwest Petroleum Co.,0,0,1,0,0,1
Southwestern Oil Syndicate,0,0,1,0,0,1
Soverign Oil,0,0,1,0,0,1
"Spanish American Oil Co., Ltd.",0,0,1,0,0,1
Spartan Drilling Co.,0,0,1,0,0,1
Spaulding Gas & Pet.,0,0,1,0,0,1
Spectrum Oil Co.,0,0,1,0,0,1
"Speedway Oil Co., Ltd.",0,0,1,0,0,1
Spencer & Brubaker,0,0,1,0,0,1
Spencer Barton,0,0,1,0,0,1
Spencer Petro. & Expl. Corp.,0,0,1,0,0,1
Spokane-Coalinga Oil Co.,0,0,1,0,0,1
Spook Oil Co.,0,0,1,0,0,1
Spreckels Oil Co.,0,0,1,0,0,1
St. Bernard Oil Co.,0,0,1,0,0,1
St. Croix Operating Inc.,0,0,1,0,0,1
St. Helens Petro.,0,0,1,0,0,1
"St. Helens Petro. Corp., Ltd",0,0,1,0,0,1
Stack Oil Co.,0,0,1,0,0,1
Stag Oil Co.,0,0,1,0,0,1
Standard Crude Oil Co.,0,0,1,0,0,1
Standard Holding Co.,0,0,1,0,0,1
Standard Oil Co.,0,0,1,0,0,1
Standlee Oil Co.,0,0,1,0,0,1
Stanford & Musolf,0,0,1,0,0,1
Stanford Petroleum Corp.,0,0,1,0,0,1
Stanislaus Oil Syndicate,0,0,1,0,0,1
Stanley Johnson,0,0,1,0,0,1
Stanley L Bauer,0,0,1,0,0,1
Stanley Oil Assoc.,0,0,1,0,0,1
Stanlite Oil Co.,0,0,1,0,0,1
Stansbury-Webb-McGoey,0,0,1,0,0,1
"Stansbury-Webb & G Greer, Trustee",0,0,1,0,0,1
Stansbury and Payne,0,0,1,0,0,1
Stanton & Bingham,0,0,1,0,0,1
"Staple Oil Co., Ltd.",0,0,1,0,0,1
"Star Petroleum Co. of Calif., Ltd",0,0,1,0,0,1
"Star Resources, Inc.",0,0,1,0,0,1
Starlyn Oil Co.,0,0,1,0,0,1
State Land Company,0,0,1,0,0,1
Steele Bros.,0,0,1,0,0,1
Stephen C. Ward,0,0,1,0,0,1
Stephen L. White,0,0,1,0,0,1
Sterling Oil Co.,0,0,1,0,0,1
Steve Smith,0,0,1,0,0,1
Steven A. Sayce,0,0,1,0,0,1
Stevens Oil Corp.,0,0,1,0,0,1
Stewart-Carter Oil Co.,0,0,1,0,0,1
Stieger Oil Co.,0,0,1,0,0,1
Stockton Oil Co.,0,0,1,0,0,1
Stockton State Hospital,0,0,1,0,0,1
Stone & Goodwin Oil Co.,0,0,1,0,0,1
Storm Industries,0,0,1,0,0,1
Strader No 2 Ltd,0,0,1,0,0,1
Strickler-Taylor Associates,0,0,1,0,0,1
"Success Energy Resources, Inc.",0,0,1,0,0,1
Sudden Oil Co.,0,0,1,0,0,1
Sullivan Drilling Inc.,0,0,1,0,0,1
Sumatra Oil Corp.,0,0,1,0,0,1
Summit Oil,0,0,1,0,0,1
Sun-Bell Drilling Co.,0,0,1,0,0,1
"Sunburst Exploration, Inc.",0,0,1,0,0,1
Sundown Energy LP,0,0,1,0,0,1
Sunhill Petro. Co.,0,0,1,0,0,1
"Sunnyvale Oil Co., Inc.",0,0,1,0,0,1
Sunrise Oil Co.,0,0,1,0,0,1
Sunrock Oil Co.,0,0,1,0,0,1
Sunset Oil Co.-Westates Petr. Corp.,0,0,1,0,0,1
Sunset Security Oil Co.,0,0,1,0,0,1
Sunshine Oil Co.,0,0,1,0,0,1
Sunview Oil Co.,0,0,1,0,0,1
Super Oil Trust,0,0,1,0,0,1
Superior Well Service Inc.,0,0,1,0,0,1
"Supreme Oil & Gas Corp., Operator",0,0,1,0,0,1
Supreme Oil Co.,0,0,1,0,0,1
Sure Oil Co.,0,0,1,0,0,1
"Surety Holding Co., Ltd.",0,0,1,0,0,1
"Surf Assoc., Inc.",0,0,1,0,0,1
Surfland Oil Co.,0,0,1,0,0,1
Surfport Oil Co.,0,0,1,0,0,1
"Sutter-Butte Oil Co., Inc.",0,0,1,0,0,1
Swain Oil Corporation,0,0,1,0,0,1
Swanton Improvement Co.,0,0,1,0,0,1
Swastika Oil Co.,0,0,1,0,0,1
Sweet Petro. Dev. Co.,0,0,1,0,0,1
Swyer Oil Co.,0,0,1,0,0,1
Sycamore Oil Co. Ltd,0,0,1,0,0,1
Syndicate Petro. Co,0,0,1,0,0,1
System Oil Co.,0,0,1,0,0,1
"T. A. Atkinson, Operator",0,0,1,0,0,1
T. B. W. Co.,0,0,1,0,0,1
T. E. Connolly,0,0,1,0,0,1
T. H. M. Aitken,0,0,1,0,0,1
T. H. Weeda Construction,0,0,1,0,0,1
T. J. Haddock and John E. Haddock,0,0,1,0,0,1
"T. Jack Bennington, Inc.",0,0,1,0,0,1
T. M. Pope,0,0,1,0,0,1
T. P. & G. Oil Co.,0,0,1,0,0,1
T. R. Murell,0,0,1,0,0,1
T. W. Branch,0,0,1,0,0,1
Taft Investment Co.,0,0,1,0,0,1
Taft Petroleum Co.,0,0,1,0,0,1
Talbott Oil Co.,0,0,1,0,0,1
Taliaferro & Turner Opr's,0,0,1,0,0,1
Talisman Oil Co.,0,0,1,0,0,1
"Tamarack Energy, Inc.",0,0,1,0,0,1
Tamarack Oil & Gas LLC,0,0,1,0,0,1
Tanner Oil Operations,0,0,1,0,0,1
TAPCO,0,0,1,0,0,1
Tassajara Oil Corp.,0,0,1,0,0,1
Taubman & Butler,0,0,1,0,0,1
Tavis-Lucian Expl. Co.,0,0,1,0,0,1
Taylor-Fitzgerald Assoc.,0,0,1,0,0,1
Taylor-Strickler Associates,0,0,1,0,0,1
Taylor Drilling & Producing Co.,0,0,1,0,0,1
Taylor Oil Co.,0,0,1,0,0,1
Ted Christenson California Oil Co.,0,0,1,0,0,1
Ted Weiner,0,0,1,0,0,1
Tehama County Oil Co.,0,0,1,0,0,1
Tehama Expl. Co.,0,0,1,0,0,1
Tejon-Kern Petroleum Co.,0,0,1,0,0,1
Tejon Hills Co.,0,0,1,0,0,1
Tejon Ranch Oil,0,0,1,0,0,1
Tejon Ridge Oil Co.,0,0,1,0,0,1
Tejon Syndicate,0,0,1,0,0,1
Tejos Prod. Co.,0,0,1,0,0,1
Temple & Lafever,0,0,1,0,0,1
"Tenacity Oil Co., Ltd.",0,0,1,0,0,1
Terminal Drlg & Prod Co.,0,0,1,0,0,1
Terra Bella Irrigation District,0,0,1,0,0,1
"Terra Petro., Inc.",0,0,1,0,0,1
Terry and Jansen,0,0,1,0,0,1
"Terry Capital, Inc.",0,0,1,0,0,1
Tesoro Denault 1 LLC,0,0,1,0,0,1
"Tesoro Petroleum, Opr.",0,0,1,0,0,1
Tevis F. Morrow,0,0,1,0,0,1
"Texaco Seaboard, Inc.",0,0,1,0,0,1
"Texam Oil Corp. & Angelus Oil Co., Inc.",0,0,1,0,0,1
Texkan Oil Co.,0,0,1,0,0,1
Texkan Oil Co. and R.R. Herring,0,0,1,0,0,1
"TGC Resources, LLC",0,0,1,0,0,1
Thanksgiving Oil Co.,0,0,1,0,0,1
The 31 Partnership,0,0,1,0,0,1
The Active Oil Co.,0,0,1,0,0,1
The Arvin Company,0,0,1,0,0,1
The Bev Oil Co.,0,0,1,0,0,1
The Boles Oil Co.,0,0,1,0,0,1
"The City of Los Angeles, Department of Airports, a municipal corporation",0,0,1,0,0,1
The Divide Ridge Oil Co.,0,0,1,0,0,1
The Dow Chemical Co.,0,0,1,0,0,1
The Flintkote Co.,0,0,1,0,0,1
The Givan Consolidated Oil Corporation,0,0,1,0,0,1
The Green Bay Co.,0,0,1,0,0,1
The Howard Co.,0,0,1,0,0,1
The Hub Oil Co.,0,0,1,0,0,1
The Hunter Living Trust,0,0,1,0,0,1
The Jacobson-Imperial Oil Co.,0,0,1,0,0,1
The Joe B. Hudson Co.,0,0,1,0,0,1
The Krik Company,0,0,1,0,0,1
The McCarthy Co.,0,0,1,0,0,1
The Mesmer City Realty Co. Ltd.,0,0,1,0,0,1
The Miocene Drilling Co.,0,0,1,0,0,1
"The Oil Scout, Inc.",0,0,1,0,0,1
The Ord Oil Co.,0,0,1,0,0,1
The Porterville Oil & Gas Co.,0,0,1,0,0,1
The Pure Oil Co.,0,0,1,0,0,1
The Red Head Oil Co.,0,0,1,0,0,1
The Southwest Foundation,0,0,1,0,0,1
The Springs,0,0,1,0,0,1
"The St. Helens Petroleum Co., Ltd.",0,0,1,0,0,1
The Three 'D' Oil Co.,0,0,1,0,0,1
The Virginian Inc.,0,0,1,0,0,1
The White Hills Oil Co.,0,0,1,0,0,1
Theodore A. Cox & John H. Tone,0,0,1,0,0,1
Theodore J. Ticktin,0,0,1,0,0,1
Theodore M. Esser,0,0,1,0,0,1
Theodore R Youderian,0,0,1,0,0,1
Theresa Franklin,0,0,1,0,0,1
Thermoil Co.,0,0,1,0,0,1
Thirty Oil Co.,0,0,1,0,0,1
Thomas & Hammill,0,0,1,0,0,1
Thomas & Housmann,0,0,1,0,0,1
Thomas B. Leddy,0,0,1,0,0,1
Thomas Carney,0,0,1,0,0,1
Thomas E. Bartell,0,0,1,0,0,1
"Thomas E. Hotz, Operator",0,0,1,0,0,1
"Thomas F. Williams, Oper.",0,0,1,0,0,1
Thomas Hagan and L.H. Scott,0,0,1,0,0,1
Thomas M. Crum,0,0,1,0,0,1
Thomas N. Fish,0,0,1,0,0,1
Thomas S. Bardeen,0,0,1,0,0,1
Thomas Strain,0,0,1,0,0,1
Thompson Dev. Co.,0,0,1,0,0,1
"Thornbury & Geis, Oper.",0,0,1,0,0,1
Thos. A. Young,0,0,1,0,0,1
Thurner Energy Corporation,0,0,1,0,0,1
Tick Canon Oil Syndicate,0,0,1,0,0,1
Tideland Expl. Co.,0,0,1,0,0,1
Tim Oil Co.,0,0,1,0,0,1
Todd-Peck Syndicate,0,0,1,0,0,1
"Toll Land XIX, LP",0,0,1,0,0,1
"Tom Bardeen, Oper.",0,0,1,0,0,1
Tom Burger & W.E. Foster,0,0,1,0,0,1
Tom Donley Land & Oil Co.,0,0,1,0,0,1
"Tom Jones, Operator",0,0,1,0,0,1
Tom O. Daniel,0,0,1,0,0,1
Tom Quarles & Assoc.,0,0,1,0,0,1
Tom R. Merrell,0,0,1,0,0,1
Tom Reed Gold Mines Co.,0,0,1,0,0,1
Tom Sharp,0,0,1,0,0,1
Tomahawk Oil & Minerals Inc.,0,0,1,0,0,1
Tompkins-Brown Oil Co.,0,0,1,0,0,1
Tonner Oil Co.,0,0,1,0,0,1
Tony Cornero,0,0,1,0,0,1
Tony Moine,0,0,1,0,0,1
Tooby Farms,0,0,1,0,0,1
Top Notch Syndicate,0,0,1,0,0,1
Top Row Oil Co.,0,0,1,0,0,1
Topa Topa Oil Co.,0,0,1,0,0,1
Toronto Midway Oil Co.,0,0,1,0,0,1
Tosco Corp.,0,0,1,0,0,1
Tosco Production Finance Corporation,0,0,1,0,0,1
Town & Country Oil Co.,0,0,1,0,0,1
Trabuca Oil Co.,0,0,1,0,0,1
Tracy Development Corp.,0,0,1,0,0,1
Tracy Harkness,0,0,1,0,0,1
Traders' Union Oil Co.,0,0,1,0,0,1
Trans-Western Oil Company,0,0,1,0,0,1
Trans Line Petroleum Corp.,0,0,1,0,0,1
Transcal Drilling Co. & J Battista Cella,0,0,1,0,0,1
"Transcalifornia Oil Co., Ltd.",0,0,1,0,0,1
Transcontinental Oil Co.,0,0,1,0,0,1
"Transcontinental Oil Co., Inc. of Nevada",0,0,1,0,0,1
Transierra & Christ,0,0,1,0,0,1
Transit Oil Co.,0,0,1,0,0,1
"Transpacific Exploration, Inc.",0,0,1,0,0,1
"Trendwell West, Inc.",0,0,1,0,0,1
Tres Carlos Exploration Co.,0,0,1,0,0,1
Tri-Centro Oil Co.,0,0,1,0,0,1
Tri-Counties Oil Co.,0,0,1,0,0,1
Tri-County Oil,0,0,1,0,0,1
Tri-Party Prod. Corp.,0,0,1,0,0,1
Tri-Party Prod. Corp. Oper.,0,0,1,0,0,1
Tri State Oil Co.,0,0,1,0,0,1
"Tri State Petro. Corp., Ltd.",0,0,1,0,0,1
Triangle Oil Co.,0,0,1,0,0,1
Trigood Oil Co.,0,0,1,0,0,1
Trinity Oil and Gas Co.,0,0,1,0,0,1
Triple A Investment Co.,0,0,1,0,0,1
Triple R Oil Co.,0,0,1,0,0,1
Triumph Oil Co.,0,0,1,0,0,1
"Triune Gas, Oil & Land Co.",0,0,1,0,0,1
Triunfo Expl. Co.,0,0,1,0,0,1
Triunfo Oil Co.,0,0,1,0,0,1
Trojan Oil Co.,0,0,1,0,0,1
Troutt Oil Co.,0,0,1,0,0,1
Troy Petro. Co.,0,0,1,0,0,1
Troy Resources Corp.,0,0,1,0,0,1
Trustees Dev. Association,0,0,1,0,0,1
Tryon & Brain,0,0,1,0,0,1
Tudor Gairdner,0,0,1,0,0,1
Tulare Basin Assoc.,0,0,1,0,0,1
Tulare Dome Oil Co.,0,0,1,0,0,1
Tulare Oil,0,0,1,0,0,1
"Tulare Well Management Company, LLC",0,0,1,0,0,1
Tule River Syndicate,0,0,1,0,0,1
Tunnel Oil Co.,0,0,1,0,0,1
Turner & Goldsberry,0,0,1,0,0,1
Turner & Tricke Co.,0,0,1,0,0,1
Turner and Assoc.,0,0,1,0,0,1
Tuscan Oil Co.,0,0,1,0,0,1
Tustin Oil Co.,0,0,1,0,0,1
Twin Buttes Oil Corp. Ltd.,0,0,1,0,0,1
Twin Oil Co.,0,0,1,0,0,1
Two Rock Oil Corp.,0,0,1,0,0,1
U & I Assoc.,0,0,1,0,0,1
U S Royalty Oil corp,0,0,1,0,0,1
U. S. Natural Gas Corp. & Fred Manning,0,0,1,0,0,1
U. S. Oil & Refining Company,0,0,1,0,0,1
U. S. Oil Scounts Exploration,0,0,1,0,0,1
"U. S. Signal Oil & Gas Co., 1971 Program",0,0,1,0,0,1
Ude-Wahlberg Assoc.,0,0,1,0,0,1
Umpire Petro. Corp.,0,0,1,0,0,1
"Unico Oil & Gas, Inc.",0,0,1,0,0,1
"Union Development Company, Inc",0,0,1,0,0,1
Union Drilling and Petro. Co.,0,0,1,0,0,1
Union Pacific Oil Co.,0,0,1,0,0,1
Union Petrochemical,0,0,1,0,0,1
Union Texas Petroleum Corp.,0,0,1,0,0,1
Uniquad Resource Co.,0,0,1,0,0,1
"United Cuban Oil, Inc.",0,0,1,0,0,1
"United Kern Petroleum Inc., Ltd.",0,0,1,0,0,1
United Oil & Gas Co.,0,0,1,0,0,1
United Security Syndicate,0,0,1,0,0,1
United States Petro. Co.,0,0,1,0,0,1
United States Petro. Corp.,0,0,1,0,0,1
United Western Cons Oil Co.,0,0,1,0,0,1
United Western Oil Co.,0,0,1,0,0,1
Universal Organic Resources,0,0,1,0,0,1
"University City Syndicate, Inc., Ltd.",0,0,1,0,0,1
Unocal-Pacific Western Oil Corp.,0,0,1,0,0,1
Urich-Lowell Oil Co.,0,0,1,0,0,1
Utacal Oil Trust,0,0,1,0,0,1
Utah Oil & Drilling Co.,0,0,1,0,0,1
Utilities Petro. Corp.,0,0,1,0,0,1
Utility Petro. Co.,0,0,1,0,0,1
V-8 Oil Co.,0,0,1,0,0,1
V & C Oil Company,0,0,1,0,0,1
V. & W. Development Co.,0,0,1,0,0,1
"V. F. Neuhaus Properties, Inc.",0,0,1,0,0,1
V. L. Howard and S. W. Mashburn,0,0,1,0,0,1
V. R. G. Wilbur,0,0,1,0,0,1
V. R. Smith,0,0,1,0,0,1
V. W. David Oil Company,0,0,1,0,0,1
"V. W. Erickson, Receiver for Magnate Oil Co.",0,0,1,0,0,1
"V. W. Erickson, Trustee for E. Preston",0,0,1,0,0,1
V.J. Puccio & Carl Doshay,0,0,1,0,0,1
Vaca Drilling Company,0,0,1,0,0,1
Vacca Oil Exploration,0,0,1,0,0,1
Valencia Co.,0,0,1,0,0,1
Valley Petro. Co.,0,0,1,0,0,1
Valley Producing Co.,0,0,1,0,0,1
Valley View Oil Co.,0,0,1,0,0,1
Valmonte,0,0,1,0,0,1
Valoco Oil Co. Ltd,0,0,1,0,0,1
"Van Noy Drilling Co., Inc",0,0,1,0,0,1
Van Nuys Oil Co.,0,0,1,0,0,1
Van Stone and Dallaston,0,0,1,0,0,1
"Vanco Development Co., Ltd.",0,0,1,0,0,1
Vanray Oil Co.,0,0,1,0,0,1
Vaughn & Assoc.,0,0,1,0,0,1
Veber-Granite Canyon Associates,0,0,1,0,0,1
Veber & Palmer,0,0,1,0,0,1
Veber Jasmin Associates,0,0,1,0,0,1
Veber Tejon Associates,0,0,1,0,0,1
Ventura-Pacific Petroleum Co.,0,0,1,0,0,1
Ventura Coast Oil Co.,0,0,1,0,0,1
Ventura County Power Co.,0,0,1,0,0,1
Ventura Drilling Co.,0,0,1,0,0,1
Ventura Drilling Services,0,0,1,0,0,1
"Ventura Energy Management, LLC",0,0,1,0,0,1
Ventura Expl. Co.,0,0,1,0,0,1
Ventura High Gravity Oil Syn.,0,0,1,0,0,1
Ventura Oil & Land Co.,0,0,1,0,0,1
Ventura Oil Dev. Co.,0,0,1,0,0,1
Ventura Oil Syn,0,0,1,0,0,1
Ventura Petro. Co.,0,0,1,0,0,1
Ventura Resources Inc.,0,0,1,0,0,1
Ventura Southern Oil Co.,0,0,1,0,0,1
Ventures Unlimited,0,0,1,0,0,1
"Verde Ent., Oper. For Ancora Corp.",0,0,1,0,0,1
"Verde Enterprises, Operator for Ancora Corporation",0,0,1,0,0,1
Verde Oil Co.,0,0,1,0,0,1
Verne Chute,0,0,1,0,0,1
Verne E. and Lorene C. Strang,0,0,1,0,0,1
Vernon I. Gandrup,0,0,1,0,0,1
Vernon T. Dark,0,0,1,0,0,1
"Vessels, Harmon & Evans",0,0,1,0,0,1
"Vesta Petroleum Co., Ltd.",0,0,1,0,0,1
Vetoil Co.,0,0,1,0,0,1
Vi-Roi Exploration,0,0,1,0,0,1
Vi-Roi Oil Inc.,0,0,1,0,0,1
Vic Saladino Co.,0,0,1,0,0,1
Vicar Petro. Corp.,0,0,1,0,0,1
Victor Bavario,0,0,1,0,0,1
Victor Berghofer,0,0,1,0,0,1
Viking Oil Co.,0,0,1,0,0,1
Viking Petro. Co.,0,0,1,0,0,1
Vincent Albano,0,0,1,0,0,1
Vintage Production California LLC,0,0,1,0,0,1
"Vista Oil & Dev. Co., Ltd.",0,0,1,0,0,1
"Von Glahn International Oil, Inc.",0,0,1,0,0,1
W & K Co. Ltd,0,0,1,0,0,1
"W. A. Bartholomae, Jr.",0,0,1,0,0,1
W. A. Dennis,0,0,1,0,0,1
W. A. Hammill,0,0,1,0,0,1
"W. Ash, J. Arden & O. Armstrong",0,0,1,0,0,1
W. B. Albright,0,0,1,0,0,1
W. B. Harrell,0,0,1,0,0,1
W. B. Trammell & Wesley West,0,0,1,0,0,1
W. C. Chapman,0,0,1,0,0,1
W. C. Hamilton,0,0,1,0,0,1
W. C. Lance,0,0,1,0,0,1
W. C. Price,0,0,1,0,0,1
W. Cady Griffith,0,0,1,0,0,1
W. D. Cannon,0,0,1,0,0,1
"W. D. Lewis, Oper.",0,0,1,0,0,1
W. D. McKoy,0,0,1,0,0,1
W. E. Goble,0,0,1,0,0,1
"W. E. Marley, Jr.",0,0,1,0,0,1
W. E. McCaslin-E. B. Kenney,0,0,1,0,0,1
W. E. Newell & E.J. Lattner,0,0,1,0,0,1
W. E. Nicolai & Assoc.,0,0,1,0,0,1
W. E. Pearson & W. C. Hamilton,0,0,1,0,0,1
W. F. Brown,0,0,1,0,0,1
W. G. Krieger,0,0,1,0,0,1
W. G. Wickey,0,0,1,0,0,1
W. H. Andrews,0,0,1,0,0,1
W. H. Coons,0,0,1,0,0,1
W. H. Davis,0,0,1,0,0,1
W. H. Fortine,0,0,1,0,0,1
W. H. Sefton,0,0,1,0,0,1
W. J. Carter and Assoc.,0,0,1,0,0,1
W. J. Cavanaugh & L. G. Sparks,0,0,1,0,0,1
W. J. Cole,0,0,1,0,0,1
W. J. Dennis,0,0,1,0,0,1
W. J. Fortier,0,0,1,0,0,1
W. J. Fortier & Assoc.,0,0,1,0,0,1
W. J. McCarthy-Wally Dennis,0,0,1,0,0,1
W. J. McMillan,0,0,1,0,0,1
W. K. D. Oil Company,0,0,1,0,0,1
W. L. Giesler,0,0,1,0,0,1
W. L. Mount,0,0,1,0,0,1
W. Leland Foreman,0,0,1,0,0,1
W. M. & M. T. Killingsworth,0,0,1,0,0,1
W. M. Richmond,0,0,1,0,0,1
W. M. S. Oil Co.,0,0,1,0,0,1
W. N. G. Oil Co.,0,0,1,0,0,1
W. O. Anderson & J.I. Anderson,0,0,1,0,0,1
W. O. Dye,0,0,1,0,0,1
W. P. Caubu and Associates,0,0,1,0,0,1
W. R. Mitchell,0,0,1,0,0,1
W. R. Paull & Assoc.,0,0,1,0,0,1
W. R. Traxler,0,0,1,0,0,1
W. S. McWhorter,0,0,1,0,0,1
W. T. Ball,0,0,1,0,0,1
"W. T. Woodward and American Placers, Inc.",0,0,1,0,0,1
W. W. Bradley,0,0,1,0,0,1
W. W. Carland,0,0,1,0,0,1
W. W. Miller,0,0,1,0,0,1
W. W. Powers,0,0,1,0,0,1
W.A.S. Oil Co.,0,0,1,0,0,1
W.J. Ball,0,0,1,0,0,1
Wahoo Oil & Gas Company,0,0,1,0,0,1
Wallace Taylor,0,0,1,0,0,1
Wally Tucker,0,0,1,0,0,1
Walter Duncan,0,0,1,0,0,1
Walter F Parker,0,0,1,0,0,1
Walter G Hibbard & Assoc,0,0,1,0,0,1
Walter G. Rowe,0,0,1,0,0,1
Walter H. Sampson,0,0,1,0,0,1
Walter M. Gleason,0,0,1,0,0,1
Walter R. Cowan & Elsie I. Cowan,0,0,1,0,0,1
Walter R. Mack,0,0,1,0,0,1
Walter S. Hunsaker,0,0,1,0,0,1
Walter Siravo,0,0,1,0,0,1
Walter W. Gregg,0,0,1,0,0,1
Walter Welton & John McGill,0,0,1,0,0,1
Ward Prod. Assoc.,0,0,1,0,0,1
Warren Oil Co. of California,0,0,1,0,0,1
Warren Sheridan,0,0,1,0,0,1
Warren W. Johnston,0,0,1,0,0,1
Warrior Petro. Corp.,0,0,1,0,0,1
Wat Khmer Temple*,0,0,1,0,0,1
Watkins-Cunningham,0,0,1,0,0,1
Watkins-McFarland,0,0,1,0,0,1
Watkins & Christensen,0,0,1,0,0,1
Watkins & Weaver,0,0,1,0,0,1
Watkins and Recknagel,0,0,1,0,0,1
Watkins Drilling Co.,0,0,1,0,0,1
Watmac Oil Co.,0,0,1,0,0,1
"Wattenbarger, Egland & Deeter",0,0,1,0,0,1
"Wattenbarger, Wattenbarger, & Stewart",0,0,1,0,0,1
Weaver-Battaglia,0,0,1,0,0,1
Weber-Butler Oil Co.,0,0,1,0,0,1
Weboc Oil Co.,0,0,1,0,0,1
Wedco Resources Corp.,0,0,1,0,0,1
Weldon Bruce,0,0,1,0,0,1
"Well Developers, Inc.",0,0,1,0,0,1
Wellco Oil Co.,0,0,1,0,0,1
"Wellman B. Mills, et al",0,0,1,0,0,1
Wells Drilling Co.,0,0,1,0,0,1
Werner & Jeanne Doellstedt,0,0,1,0,0,1
Wesco Petroleum Co.,0,0,1,0,0,1
West Bay Expl. Co.,0,0,1,0,0,1
West Coast Dev. Corp.,0,0,1,0,0,1
West Coast Drilling Co.,0,0,1,0,0,1
West Coast Oil Corp.,0,0,1,0,0,1
West Coast Petroleum Company,0,0,1,0,0,1
West Coast Refining Co.,0,0,1,0,0,1
West Dominguez Assoc.,0,0,1,0,0,1
West Elwood Oil Co,0,0,1,0,0,1
West Kern Oil Co.,0,0,1,0,0,1
"West Kern Oil Museum, Inc.",0,0,1,0,0,1
West Montebello Oil Co.,0,0,1,0,0,1
West Oil,0,0,1,0,0,1
West Penn Producing Co.,0,0,1,0,0,1
Westbrook Company,0,0,1,0,0,1
"Western Continent Minerals, Ltd.",0,0,1,0,0,1
Western Drilling & Production Co.,0,0,1,0,0,1
Western Drilling Co. Inc.,0,0,1,0,0,1
Western Exploration Company,0,0,1,0,0,1
"Western Gulf Oil of California, Inc.",0,0,1,0,0,1
Western Meridian Oil,0,0,1,0,0,1
Western Natural Resources Corp. and E. B. Guess,0,0,1,0,0,1
"Western Oil & Exploration Co., Ltd.",0,0,1,0,0,1
Western Oil Fields Supply Co.,0,0,1,0,0,1
"Western Option Co., Inc.",0,0,1,0,0,1
Western Pacific Res. Corp.,0,0,1,0,0,1
Western Prod.,0,0,1,0,0,1
"Western Research Laboratories, Inc.",0,0,1,0,0,1
Westgate-California Realty Co.,0,0,1,0,0,1
Westkern Oil Co.,0,0,1,0,0,1
Westkern Oil Corp.,0,0,1,0,0,1
Westlake Gas Co.,0,0,1,0,0,1
"Westlake Pet. Exploration, LLC",0,0,1,0,0,1
Westmex Limited,0,0,1,0,0,1
"Westmont Oil, Inc.",0,0,1,0,0,1
"WH Soledad Circle 139, LP",0,0,1,0,0,1
Whidden Double Oil Co.,0,0,1,0,0,1
White Behr Consolidated Oil Co.,0,0,1,0,0,1
White Co.,0,0,1,0,0,1
White Five Oil Co.,0,0,1,0,0,1
White Oil Co.,0,0,1,0,0,1
White Star Oil,0,0,1,0,0,1
White Wolf Associates,0,0,1,0,0,1
Whiting Petroleum Corp.,0,0,1,0,0,1
Whitley & Van Antwerp,0,0,1,0,0,1
Whittier Narrows Oil Co.,0,0,1,0,0,1
Wil-Daw Oil Co.,0,0,1,0,0,1
Wilbur Clark,0,0,1,0,0,1
Wilcox & Fleishacker,0,0,1,0,0,1
Wildcat Oil & Royalty Co.,0,0,1,0,0,1
Wilexco Inc.,0,0,1,0,0,1
Wilfred Wiersma & Charleen Wiersma,0,0,1,0,0,1
Willard J. Classen & Assoc.,0,0,1,0,0,1
Willard Mallery,0,0,1,0,0,1
Willard Martin,0,0,1,0,0,1
"Willette Oil Co., Inc.",0,0,1,0,0,1
William A. Clark,0,0,1,0,0,1
William A. Sears,0,0,1,0,0,1
William B. Comozzi,0,0,1,0,0,1
"William B. Fisher, Trustee",0,0,1,0,0,1
William C. Blanks,0,0,1,0,0,1
William D. Reis,0,0,1,0,0,1
"William F. Daggett, Jr.",0,0,1,0,0,1
William F. Wrath,0,0,1,0,0,1
William H. Colvin,0,0,1,0,0,1
William H. Doheny,0,0,1,0,0,1
William H. Provost,0,0,1,0,0,1
William H. Rector,0,0,1,0,0,1
"William Harrison Taylor, Trustee",0,0,1,0,0,1
William J. Martini & Eugene Van Grinsven,0,0,1,0,0,1
William J. Murray,0,0,1,0,0,1
William J. Ripling,0,0,1,0,0,1
William L. Hernstadt,0,0,1,0,0,1
William L. Kumler,0,0,1,0,0,1
William L. Rawn,0,0,1,0,0,1
William M. Kelso,0,0,1,0,0,1
William S. Millener,0,0,1,0,0,1
William T. McKenzie,0,0,1,0,0,1
William U. Watson & W. Lichlyter,0,0,1,0,0,1
William W. Howard,0,0,1,0,0,1
William W. Moreland,0,0,1,0,0,1
Williams Brothers Oil Co.,0,0,1,0,0,1
Williams Petro. Corp.,0,0,1,0,0,1
Williamson & Dahaher,0,0,1,0,0,1
Willis W. Bryant,0,0,1,0,0,1
Willits Oil & Gas Co.,0,0,1,0,0,1
Willow Springs Oil Co.,0,0,1,0,0,1
Wilmington Terminal Oil Co.,0,0,1,0,0,1
Wilmore and Hazzard,0,0,1,0,0,1
Wilshire-Annex Oil Co.,0,0,1,0,0,1
Wilshire Country Club,0,0,1,0,0,1
Wilson-Anderson Oil Co.,0,0,1,0,0,1
Wilson-Peterson Oil Co.,0,0,1,0,0,1
Wilson & Wilson,0,0,1,0,0,1
Wilson Anderson Oil Co.,0,0,1,0,0,1
Wilson O. Gage,0,0,1,0,0,1
"Wilson Oil Co., Operator",0,0,1,0,0,1
Wilson Petro. Co.,0,0,1,0,0,1
Wilton Oil Co.,0,0,1,0,0,1
Winifred Schneider,0,0,1,0,0,1
Winlock Oil Co.,0,0,1,0,0,1
Winnipeg Oil Co.,0,0,1,0,0,1
Wm Diller,0,0,1,0,0,1
Wm. A. Kirk.,0,0,1,0,0,1
"Wm. A. Thornbury, Inc.",0,0,1,0,0,1
Wm. Bosustow,0,0,1,0,0,1
Wm. C. McDuffie,0,0,1,0,0,1
Wm. Carter Jr.,0,0,1,0,0,1
Wm. G. Helis,0,0,1,0,0,1
"Wm. G. McAdoo, Jr",0,0,1,0,0,1
Wm. Gilbert,0,0,1,0,0,1
Wm. H. Cree - Cannon Lease,0,0,1,0,0,1
Wm. Hauhuth Oil Co.,0,0,1,0,0,1
Wm. J. Rennick,0,0,1,0,0,1
Wm. J. Stava,0,0,1,0,0,1
Wm. Kelly,0,0,1,0,0,1
"Wm. M. Thornbury, W. H. Geis and John M. Robinson",0,0,1,0,0,1
Wm. P. Lasher Chas. Schmitz,0,0,1,0,0,1
Wm. R. and Dorothy G. Boardman,0,0,1,0,0,1
"Wolverine Oil Co., Ltd.",0,0,1,0,0,1
Wonder Oil Co.,0,0,1,0,0,1
Wonder Oil Corp.,0,0,1,0,0,1
Wood-Callahan Oil Co.,0,0,1,0,0,1
Woodmar Partnership,0,0,1,0,0,1
Woodward & Sheedy,0,0,1,0,0,1
Woodward Petroleum,0,0,1,0,0,1
Worland Assoc,0,0,1,0,0,1
Worland Oil Co.,0,0,1,0,0,1
World Continental Enterprises,0,0,1,0,0,1
World Oil Co.,0,0,1,0,0,1
Worley & Abrams,0,0,1,0,0,1
Worthen Canyon Oil Co.,0,0,1,0,0,1
WP Wellco LLC,0,0,1,0,0,1
WPG Bakersfield LLC,0,0,1,0,0,1
Wright Oil Tool Co.,0,0,1,0,0,1
Wyman & Camarillo,0,0,1,0,0,1
X O Expl. Inc.,0,0,1,0,0,1
"XTX, INC.",0,0,1,0,0,1
"Yatura Petro., Inc.",0,0,1,0,0,1
"Yellowstone Oil Co., Ltd.",0,0,1,0,0,1
Yolo Oil Corp.,0,0,1,0,0,1
Yorba Oil Co.,0,0,1,0,0,1
York-Smullin Oil Co.,0,0,1,0,0,1
Young & Bryan,0,0,1,0,0,1
Young & Green,0,0,1,0,0,1
Young & Johnson,0,0,1,0,0,1
Young Brothers,0,0,1,0,0,1
Young Napoleon Oil Co.,0,0,1,0,0,1
Young Oil Co.,0,0,1,0,0,1
Youngs Bros.,0,0,1,0,0,1
Yuba Expl. Co.,0,0,1,0,0,1
Yuba Goldfields Inc.,0,0,1,0,0,1
Zars Oil Company,0,0,1,0,0,1
"Zenergy, Inc.",0,0,1,0,0,1
Zone Petroleum Corp.,0,0,1,0,0,1
Zurich Oil Co.,0,0,1,0,0,1
E. J. Boust,0,0,0,0,1,1
"A. M. Nahabedian & G. D. Fawcett, Operators",0,0,0,0,0,0
Ada Oil Co.,0,0,0,0,0,0
Alanmar Oil Company,0,0,0,0,0,0
Alford & Elliott,0,0,0,0,0,0
APCO Oil Corporation,0,0,0,0,0,0
"Armstrong Farms, Inc.",0,0,0,0,0,0
Berry & Ewing,0,0,0,0,0,0
"Bonanza Creek Energy Operating Company, LLC",0,0,0,0,0,0
Breitburn Operating LP,0,0,0,0,0,0
Brinkman-Nelson Oil Operations,0,0,0,0,0,0
Buttes Gas & Oil Co.,0,0,0,0,0,0
Cal-Ute Oil Co.,0,0,0,0,0,0
"Calpine Natural Gas, L.P.",0,0,0,0,0,0
Carrec Oil Associates,0,0,0,0,0,0
"Castle Peak Resources, L.L.C.",0,0,0,0,0,0
Cemco-Edison 1980a Partnership,0,0,0,0,0,0
"Central Resources, Inc.",0,0,0,0,0,0
"Champion Energy Co., Inc.",0,0,0,0,0,0
Chevron USA Inc.,0,0,0,0,0,0
City of Bakersfield Solid Waste Division,0,0,0,0,0,0
"Compass Global Resources, LLC",0,0,0,0,0,0
Core Energy LLC,0,0,0,0,0,0
"Crest Energy, Inc.",0,0,0,0,0,0
Crutcher-Tufts Corporation,0,0,0,0,0,0
Crutcher-Tufts Production Company,0,0,0,0,0,0
Double Barrel Oil Co.,0,0,0,0,0,0
Elberta Oil Co.,0,0,0,0,0,0
Ethel D Co.,0,0,0,0,0,0
Exxon San Joaquin Production Co.,0,0,0,0,0,0
Ferrell G. Nixon,0,0,0,0,0,0
"Foothills California, Inc.",0,0,0,0,0,0
Formax Oil Company,0,0,0,0,0,0
Fred S. Holmes,0,0,0,0,0,0
Gasco Production Company,0,0,0,0,0,0
"Global Oil Production, LLC",0,0,0,0,0,0
Incremental Oil and Gas USA Holdings Inc.,0,0,0,0,0,0
Incremental Petroleum (USA) Inc.,0,0,0,0,0,0
Ivanhoe Energy (USA) Inc.,0,0,0,0,0,0
J. C. Thompson,0,0,0,0,0,0
Jess Douglas Oil Operations,0,0,0,0,0,0
Johnson & Brown,0,0,0,0,0,0
K. R.  Evans & Assoc.,0,0,0,0,0,0
Kern County Refinery Inc.,0,0,0,0,0,0
"KMD Operating Company, LLC",0,0,0,0,0,0
"Laris Oil & Gas, LLC",0,0,0,0,0,0
"Linn Operating, LLC",0,0,0,0,0,0
"Linn Western Operating, Inc.",0,0,0,0,0,0
"Lukoil (Americas), LLC",0,0,0,0,0,0
M. H. Whittier Corporation,0,0,0,0,0,0
"Marathon Oil Company, Operator",0,0,0,0,0,0
Mericle Oil Co.,0,0,0,0,0,0
MetGas Industries (USA) Ltd.,0,0,0,0,0,0
Midcal Production Service Inc.,0,0,0,0,0,0
Nations Petroleum (California) LLC,0,0,0,0,0,0
Nations Petroleum U.S.A. Ltd.,0,0,0,0,0,0
Navy-Brinkman Oil Operations,0,0,0,0,0,0
New Energy West Corporation,0,0,0,0,0,0
NGC Energy Co.,0,0,0,0,0,0
NOR-AM Exploration Corp.,0,0,0,0,0,0
"Occidental of Elk Hills, Inc.",0,0,0,0,0,0
Oxy USA Inc.,0,0,0,0,0,0
"Phoenix Energy, Inc.",0,0,0,0,0,0
Poso Creek Petroleum LLC,0,0,0,0,0,0
PYR Energy Corporation,0,0,0,0,0,0
R. L. Staats,0,0,0,0,0,0
Roya Resources LLC,0,0,0,0,0,0
"Schaefer Oil Co., Inc.",0,0,0,0,0,0
Schaefer Oil Company,0,0,0,0,0,0
"Seneca Resources Company, LLC",0,0,0,0,0,0
Seneca Western Minerals Corp.,0,0,0,0,0,0
Shell Calif. Prod. Inc.,0,0,0,0,0,0
Shell California Prod. Inc.,0,0,0,0,0,0
"Shell Oil Co., Unit Opr.",0,0,0,0,0,0
Shore Capital LLC,0,0,0,0,0,0
"Site Resources, Inc.",0,0,0,0,0,0
"Stockdale Oil & Gas, Inc.",0,0,0,0,0,0
Summit Development Corp.,0,0,0,0,0,0
Sunray DX Oil Company,0,0,0,0,0,0
"Surety Drilling, Inc.",0,0,0,0,0,0
Surprise Oil Company,0,0,0,0,0,0
"Tannehill Oil Company, Inc.",0,0,0,0,0,0
Target Petroleum Company,0,0,0,0,0,0
Tartan Energy U.S.A. Corp.,0,0,0,0,0,0
Texaco California Inc.,0,0,0,0,0,0
Texaco Exploration and Production Inc.,0,0,0,0,0,0
Texaco Inc.,0,0,0,0,0,0
U.S.B. Oil Company,0,0,0,0,0,0
"Vista Energy, LLC",0,0,0,0,0,0
"Western Oil Independent, LLC",0,0,0,0,0,0
Western Production Inc.,0,0,0,0,0,0
William H. Perry,0,0,0,0,0,0
Williams Brothers Engineering Company,0,0,0,0,0,0
Windes & Newsom Associates,0,0,0,0,0,0
Xploration Inc.,0,0,0,0,0,0
Zodiac Energy LLC,0,0,0,0,0,0
